person,trial,x,y,dur,on,off,n,timeInt,block
1,1,947.3,544,1361,-271,1090,1,waiting,1
1,1,1127.7,552.7,480,1118,1598,2,targOff,1
1,2,949.8,544.6,1234,-280,954,1,waiting,1
1,2,1124.1,545.3,433,981,1414,2,targOff,1
1,3,951.9,545.8,1214,-52,1162,1,waiting,1
1,3,765.1,545.7,455,1188,1643,2,targOff,1
1,4,952.2,547.3,1169,-280,889,1,waiting,1
1,4,1145.2,551.1,513,916,1429,2,targOff,1
1,5,954.8,548.8,1144,-286,858,1,waiting,1
1,5,1136.1,539.9,171,893,1064,2,waiting,1
1,6,954.7,548.1,1593,-279,1314,1,waiting,1
1,6,767.6,546.3,449,1346,1795,2,targOff,1
1,7,952.5,551.7,1652,-295,1357,1,waiting,1
1,7,760.1,550.7,425,1385,1810,2,targOff,1
1,8,947.4,553.4,1499,-283,1216,1,waiting,1
1,8,754.9,553.4,412,1252,1664,2,targOff,1
1,9,941.7,554.3,1279,-282,997,1,waiting,1
1,9,767,550.9,436,1024,1460,2,targOff,1
1,10,939.3,557.1,1668,-278,1390,1,waiting,1
1,10,750.9,553.7,461,1420,1881,2,targOff,1
1,11,949.1,543.5,1258,-282,976,1,waiting,1
1,11,1113,544.4,603,1011,1614,2,dotOff,1
1,12,944.6,550.3,1360,-273,1087,1,waiting,1
1,12,757.9,546.7,443,1121,1564,2,targOff,1
1,13,937.3,549.8,1659,-283,1376,1,waiting,1
1,13,757.3,542.2,455,1409,1864,2,targOff,1
1,14,941.5,546.2,1232,-22,1210,1,waiting,1
1,14,1116.3,543.4,420,1244,1664,2,targOff,1
1,15,940.5,547.2,1467,-282,1185,1,waiting,1
1,15,770.7,551.3,403,1211,1614,2,targOff,1
1,16,941.7,547.5,1568,-290,1278,1,waiting,1
1,16,1088.1,549.8,419,1302,1721,2,targVis,1
1,16,1130.6,544.3,109,1738,1847,3,targOff,1
1,17,933.6,548.6,1584,-284,1300,1,waiting,1
1,17,746.6,550,426,1338,1764,2,targOff,1
1,18,948.4,550.6,1512,-280,1232,1,waiting,1
1,18,1103.7,549.9,422,1258,1680,2,targOff,1
1,19,934.9,553,1599,-194,1405,1,waiting,1
1,19,752.2,547.2,441,1440,1881,2,targOff,1
1,20,935.1,547.4,1664,-280,1384,1,waiting,1
1,20,1115.5,548.6,425,1418,1843,2,targOff,1
1,21,938,546.3,1411,-285,1126,1,waiting,1
1,21,1118.3,555.9,427,1153,1580,2,targOff,1
1,22,940.5,554.5,1326,-274,1052,1,waiting,1
1,22,1129.2,550.7,428,1086,1514,2,targOff,1
1,23,943.7,561.3,1325,-37,1288,1,waiting,1
1,23,733.6,552.9,453,1325,1778,2,targOff,1
1,24,935.2,557.9,1338,-287,1051,1,waiting,1
1,24,1113,552.1,728,1086,1814,2,waiting,1
1,25,971.6,543.3,644,-281,363,1,waiting,1
1,25,945.4,525.7,236,695,931,2,waiting,1
1,26,982.1,586.6,267,-93,174,1,waiting,1
1,26,941.4,549.2,919,187,1106,2,waiting,1
1,26,729.8,548,456,1142,1598,3,targOff,1
1,27,938.1,553.9,1295,-278,1017,1,waiting,1
1,27,765,542.5,429,1051,1480,2,targOff,1
1,28,944.5,552.6,1367,-282,1085,1,waiting,1
1,28,766.7,549.3,464,1113,1577,2,targOff,1
1,29,941.3,555.5,1677,-282,1395,1,waiting,1
1,29,775.4,549.4,443,1421,1864,2,targOff,1
1,30,936.2,560.5,1560,-281,1279,1,waiting,1
1,30,1117.1,552,448,1312,1760,2,targOff,1
1,31,944,546.4,1499,-274,1225,1,waiting,1
1,31,832.4,552,178,1247,1425,2,targOff,1
1,31,758.4,551.2,171,1443,1614,3,targOff,1
1,32,946,557.4,1338,-281,1057,1,waiting,1
1,32,1118.3,554.3,470,1090,1560,2,targOff,1
1,33,937.3,548.8,2108,-277,1831,1,waiting,1
1,34,933.9,551.9,1075,-25,1050,1,waiting,1
1,34,1134.4,550.1,461,1086,1547,2,targOff,1
1,35,937.3,551.5,1753,-287,1466,1,waiting,1
1,35,755.8,550,415,1498,1913,2,targOff,1
1,36,935.2,554.4,1383,-203,1180,1,waiting,1
1,36,1108.5,551.7,439,1208,1647,2,targOff,1
1,37,935.9,552.1,1705,-282,1423,1,waiting,1
1,37,762.9,551.5,409,1456,1865,2,targOff,1
1,38,942.4,549.1,1690,-280,1410,1,waiting,1
1,38,1104.1,550.9,420,1441,1861,2,targOff,1
1,39,933.3,554.6,1524,-285,1239,1,waiting,1
1,39,1126.8,551,482,1265,1747,2,targOff,1
1,40,934.3,558,1448,-45,1403,1,waiting,1
1,40,1106.7,556.8,453,1428,1881,2,targOff,1
1,1,862.3,549.5,226,-12,214,1,waiting,2
1,1,901.1,540.2,265,227,492,2,waiting,2
1,1,943.6,544.6,643,504,1147,3,waiting,2
1,2,946.9,542.2,1711,-281,1430,1,waiting,2
1,3,944.8,534.6,2031,-284,1747,1,waiting,2
1,4,945.9,550.6,2099,-285,1814,1,waiting,2
1,5,948.7,533.1,1710,-281,1429,1,waiting,2
1,6,945.8,543.9,1984,-270,1714,1,waiting,2
1,7,943.9,540.6,2018,-271,1747,1,waiting,2
1,8,942.7,543.6,1766,-285,1481,1,waiting,2
1,9,944.9,538.9,1999,-285,1714,1,waiting,2
1,10,950,538.5,1921,-274,1647,1,waiting,2
1,11,947.2,541.6,1840,-280,1560,1,waiting,2
1,12,951.5,543.1,2123,-276,1847,1,waiting,2
1,13,948.8,552.2,1925,-28,1897,1,waiting,2
1,14,946.6,544.8,1943,-46,1897,1,waiting,2
1,15,948.6,540.8,1943,-280,1663,1,waiting,2
1,16,945,545.5,1772,-275,1497,1,waiting,2
1,17,948.8,551.1,1924,-277,1647,1,waiting,2
1,18,944.4,539.2,2170,-273,1897,1,waiting,2
1,19,947.3,534.8,2032,-285,1747,1,waiting,2
1,20,950,541.1,1742,-278,1464,1,waiting,2
1,21,948.8,540.9,1521,-41,1480,1,waiting,2
1,22,951.9,537.7,1855,-59,1796,1,waiting,2
1,23,950.7,545.9,2111,-280,1831,1,waiting,2
1,24,950.2,545.5,1927,-280,1647,1,waiting,2
1,25,955.4,549.7,1761,-279,1482,1,waiting,2
1,26,951.8,543.4,1519,-22,1497,1,waiting,2
1,27,951.1,543.3,1969,-272,1697,1,waiting,2
1,28,950.7,531.8,1527,-47,1480,1,waiting,2
1,29,952.6,530.8,1911,-280,1631,1,waiting,2
1,30,942.2,542.4,1512,2,1514,1,waiting,2
1,31,945.5,541.5,2163,-283,1880,1,waiting,2
1,32,941.3,553.5,1759,-278,1481,1,waiting,2
1,33,947.8,545.4,2158,-281,1877,1,waiting,2
1,34,934.2,537.5,1909,-62,1847,1,waiting,2
1,35,942.1,547.2,2027,-281,1746,1,waiting,2
1,36,944,543.2,1907,-280,1627,1,waiting,2
1,37,941.7,536.4,2124,-277,1847,1,waiting,2
1,38,924.5,548.9,148,-47,101,1,waiting,2
1,38,938.1,538.4,1622,109,1731,2,waiting,2
1,39,937.1,545.4,1492,-65,1427,1,waiting,2
1,40,939.9,542.4,1807,-277,1530,1,waiting,2
1,1,954.2,539.5,1202,-31,1171,1,waiting,3
1,1,767.9,535.1,434,1197,1631,2,targOff,3
1,2,941.4,541.5,1457,-272,1185,1,waiting,3
1,2,1122.5,543.6,493,1221,1714,2,targOff,3
1,3,949.2,534.4,1344,-278,1066,1,waiting,3
1,3,1121.9,542.8,520,1094,1614,2,targVis,3
1,4,945.3,531.6,1509,-281,1228,1,waiting,3
1,4,784.3,538.9,472,1254,1726,2,targOff,3
1,5,942.3,533,1131,-286,845,1,waiting,3
1,5,857.2,537.8,423,864,1287,2,waiting,3
1,5,764.9,536.6,456,1308,1764,3,targOff,3
1,6,940.9,537.5,1357,-11,1346,1,waiting,3
1,6,1105.3,543,472,1372,1844,2,targOff,3
1,7,937.9,539.3,1388,-276,1112,1,waiting,3
1,7,764,536,456,1139,1595,2,targOff,3
1,8,942.4,535.5,886,-4,882,1,waiting,3
1,8,1121.8,534.2,164,917,1081,2,waiting,3
1,9,942.6,539,1388,-281,1107,1,waiting,3
1,9,761.3,533.9,719,1143,1862,2,waiting,3
1,10,941.3,544.8,1426,-109,1317,1,waiting,3
1,10,1116.2,548.6,430,1350,1780,2,targOff,3
1,11,942.9,535.5,1329,-286,1043,1,waiting,3
1,11,769.9,538.6,430,1068,1498,2,targOff,3
1,12,941.9,540.7,1279,-45,1234,1,waiting,3
1,12,789.8,537,438,1259,1697,2,targOff,3
1,13,945.2,538.9,1312,-71,1241,1,waiting,3
1,13,768.5,533,462,1269,1731,2,targOff,3
1,14,946.7,540.2,1464,-284,1180,1,waiting,3
1,14,1113,543.1,416,1215,1631,2,targOff,3
1,15,956.1,529.5,341,-288,53,1,waiting,3
1,15,936.1,537.3,1362,60,1422,2,waiting,3
1,15,770.6,538.2,449,1449,1898,3,targOff,3
1,16,938.6,537.4,1151,-44,1107,1,waiting,3
1,16,1123,542.2,481,1133,1614,2,targOff,3
1,17,939.7,529.7,297,-281,16,1,waiting,3
1,17,942.8,541.2,1168,24,1192,2,waiting,3
1,17,729.7,546.1,186,1223,1409,3,targOff,3
1,18,936.6,543.6,1727,-286,1441,1,waiting,3
1,18,1084.4,551.2,244,1470,1714,2,targOff,3
1,18,1124,544.1,150,1731,1881,3,targOff,3
1,19,938.5,549.1,1265,-286,979,1,waiting,3
1,19,1124.3,545.2,416,1014,1430,2,targOff,3
1,20,944.5,543.6,1334,-282,1052,1,waiting,3
1,20,1078.5,541.9,360,1078,1438,2,waiting,3
1,20,1121.4,543.4,427,1453,1880,3,targOff,3
1,21,942.4,541.8,1482,-276,1206,1,waiting,3
1,21,1071,546.1,204,1231,1435,2,dotOff,3
1,21,1096.2,550.2,329,1452,1781,3,targOff,3
1,22,961.2,543.6,128,-112,16,1,waiting,3
1,22,933,545.9,1221,27,1248,2,waiting,3
1,22,773.3,540.6,453,1274,1727,3,targOff,3
1,23,937.9,536.9,1565,-283,1282,1,waiting,3
1,23,775.3,537.3,457,1307,1764,2,targOff,3
1,24,939.6,539.6,1194,-281,913,1,waiting,3
1,24,753.9,540.1,290,941,1231,2,waiting,3
1,25,908,540,288,-275,13,1,waiting,3
1,25,935.8,545.8,1306,23,1329,2,waiting,3
1,25,1115,549.3,476,1355,1831,3,targOff,3
1,26,936.4,540.4,1509,-282,1227,1,waiting,3
1,26,1114.2,540.5,461,1253,1714,2,targOff,3
1,27,944.7,542.7,1519,-282,1237,1,waiting,3
1,27,765.8,545.2,468,1263,1731,2,targOff,3
1,28,937.7,541.7,1468,-38,1430,1,waiting,3
1,28,1134.5,547.7,444,1466,1910,2,targOff,3
1,29,938,544.6,1152,-46,1106,1,waiting,3
1,29,1120.9,551.1,456,1142,1598,2,targOff,3
1,30,941,538.6,1703,-285,1418,1,waiting,3
1,30,1105.9,543.8,442,1451,1893,2,targOff,3
1,31,1119.3,559.7,297,-280,17,1,waiting,3
1,31,964.3,540.5,195,41,236,2,waiting,3
1,31,936.5,546.7,810,245,1055,3,waiting,3
1,31,757.7,545.6,388,1093,1481,4,targOff,3
1,32,939.6,547.9,1672,-281,1391,1,waiting,3
1,32,774.1,541.7,444,1415,1859,2,targOff,3
1,33,938.3,550.2,1527,-281,1246,1,waiting,3
1,33,1096.1,540.2,441,1271,1712,2,targOff,3
1,34,927,529.8,327,-278,49,1,waiting,3
1,34,939.5,536.6,1053,56,1109,2,waiting,3
1,34,1109.7,550.3,437,1143,1580,3,targOff,3
1,35,941.9,544.3,1553,-273,1280,1,waiting,3
1,35,1118.4,546.3,491,1306,1797,2,targOff,3
1,36,934.9,544.5,1423,-19,1404,1,waiting,3
1,36,755,538.9,450,1430,1880,2,targOff,3
1,37,936.4,543.2,1276,-281,995,1,waiting,3
1,37,777,542.2,396,1018,1414,2,targOff,3
1,38,943.3,546.7,1076,-33,1043,1,waiting,3
1,38,1126.7,545.4,467,1080,1547,2,targOff,3
1,39,935.6,547.9,1267,0,1267,1,waiting,3
1,39,769,538.3,456,1291,1747,2,targOff,3
1,40,943.7,552.5,1203,-77,1126,1,waiting,3
1,40,1091.8,544.7,271,1151,1422,2,waiting,3
1,40,1125.3,550.5,400,1443,1843,3,targOff,3
1,1,940.9,542,1911,-180,1731,1,waiting,4
1,2,938.7,542.4,1650,-53,1597,1,waiting,4
1,3,941.9,547.6,1932,-285,1647,1,waiting,4
1,4,941.1,548.2,1920,-272,1648,1,waiting,4
1,5,943.3,542.3,1782,-1,1781,1,waiting,4
1,6,939.5,548.1,2166,-284,1882,1,waiting,4
1,7,939.7,550.3,1482,-51,1431,1,waiting,4
1,8,937,541.9,2185,-287,1898,1,waiting,4
1,9,988,562.9,286,-273,13,1,waiting,4
1,9,942.6,545.8,1871,26,1897,2,waiting,4
1,10,938.6,553.6,1763,-283,1480,1,waiting,4
1,11,942.9,554.6,1888,-290,1598,1,waiting,4
1,12,949.2,556.9,1819,-288,1531,1,waiting,4
1,13,943.4,546.9,1814,-34,1780,1,waiting,4
1,14,939.1,551.1,1891,-10,1881,1,waiting,4
1,15,938.4,551.5,1808,6,1814,1,waiting,4
1,16,949.4,544.7,2182,-285,1897,1,waiting,4
1,17,942.2,548,2052,-288,1764,1,waiting,4
1,18,897.5,538.9,144,-118,26,1,waiting,4
1,18,933.9,547.8,1703,44,1747,2,waiting,4
1,19,968.7,584.4,473,-271,202,1,waiting,4
1,19,932.8,550.5,1344,221,1565,2,waiting,4
1,20,924.2,631.7,319,-287,32,1,waiting,4
1,20,961.5,546.1,1423,57,1480,2,waiting,4
1,21,936.9,547.6,1719,-205,1514,1,waiting,4
1,22,945.1,544,2190,-280,1910,1,waiting,4
1,23,949,546,1816,-2,1814,1,waiting,4
1,24,944.3,545.2,1910,-29,1881,1,waiting,4
1,25,936,551.6,1921,-274,1647,1,waiting,4
1,26,935,546.9,1806,9,1815,1,waiting,4
1,27,939.7,549.5,2168,-288,1880,1,waiting,4
1,28,941.7,527.1,234,-66,168,1,waiting,4
1,28,962.1,513.7,149,327,476,2,waiting,4
1,28,933.4,547.2,706,492,1198,3,waiting,4
1,29,965.4,518.4,39,303,342,1,waiting,4
1,29,919.9,532.7,62,481,543,2,waiting,4
1,29,945.5,523.5,56,694,750,3,waiting,4
1,29,928.7,572.8,47,884,931,4,waiting,4
1,30,937.8,539.3,1985,-288,1697,1,waiting,4
1,31,926.2,519.7,168,-85,83,1,waiting,4
1,31,932.6,545,1566,98,1664,2,waiting,4
1,32,935.5,544,1930,-287,1643,1,waiting,4
1,33,932.7,542.6,1439,-13,1426,1,waiting,4
1,34,928.3,542.4,1775,-44,1731,1,waiting,4
1,35,931.5,532.4,1918,-287,1631,1,waiting,4
1,36,938.8,542.5,1821,-27,1794,1,waiting,4
1,37,943.7,544.5,1619,12,1631,1,waiting,4
1,38,933.8,550,1523,-11,1512,1,waiting,4
1,39,959.8,540.6,136,-133,3,1,waiting,4
1,39,938,543.3,1835,12,1847,2,waiting,4
1,40,936.1,538.3,1942,-178,1764,1,waiting,4
1,1,932.4,552.9,1295,-284,1011,1,waiting,5
1,1,723.7,551.2,162,1048,1210,2,targOff,5
1,1,741.6,551.3,297,1218,1515,3,targOff,5
1,2,936.4,548.5,1157,-20,1137,1,waiting,5
1,2,1109.5,541.5,453,1162,1615,2,targOff,5
1,3,941.5,536.1,1418,-275,1143,1,waiting,5
1,3,1131.6,541.6,438,1175,1613,2,targOff,5
1,4,938.6,537.2,1510,-280,1230,1,waiting,5
1,4,767.8,542.3,457,1255,1712,2,targOff,5
1,5,935.5,541.6,1469,-275,1194,1,waiting,5
1,5,792.7,535.6,170,1217,1387,2,targVis,5
1,5,766.4,536.1,351,1396,1747,3,targOff,5
1,6,936.1,534.8,1286,-270,1016,1,waiting,5
1,6,1077.9,543.7,419,1042,1461,2,targOff,5
1,6,1111.3,543,72,1476,1548,3,targOff,5
1,7,912.7,550.2,185,-164,21,1,waiting,5
1,7,936.8,545.1,1357,29,1386,2,waiting,5
1,7,763.3,542.7,452,1412,1864,3,targOff,5
1,8,937.6,544.6,1385,-298,1087,1,waiting,5
1,8,1129.2,540.5,463,1113,1576,2,targOff,5
1,9,939.5,546.7,1451,-285,1166,1,waiting,5
1,9,770.4,537.9,489,1192,1681,2,targOff,5
1,10,939.5,550.1,1345,-275,1070,1,waiting,5
1,10,1120.1,541.7,484,1097,1581,2,targOff,5
1,11,938.9,548.8,1130,-57,1073,1,waiting,5
1,11,1121.6,541.2,443,1105,1548,2,targOff,5
1,12,943.5,537.4,1429,-286,1143,1,waiting,5
1,12,762.6,544.2,429,1168,1597,2,targOff,5
1,13,944,548.1,1325,-276,1049,1,waiting,5
1,13,1116.2,547.6,543,1088,1631,2,targVis,5
1,14,939.3,549.7,1369,-289,1080,1,waiting,5
1,14,780.4,536,426,1104,1530,2,targOff,5
1,15,949.3,543.6,1068,-248,820,1,waiting,5
1,15,1133,548.6,280,851,1131,2,waiting,5
1,16,955.3,542.3,202,-157,45,1,waiting,5
1,16,931.1,546.3,1161,53,1214,2,waiting,5
1,16,764.9,546.9,474,1240,1714,3,targOff,5
1,17,941.4,549.8,1534,-272,1262,1,waiting,5
1,17,774.2,542.3,461,1287,1748,2,targOff,5
1,18,938.4,546.5,1351,-275,1076,1,waiting,5
1,18,1120.3,544.3,581,1116,1697,2,dotOff,5
1,19,940.2,534.9,1035,3,1038,1,waiting,5
1,19,760.5,533.1,461,1070,1531,2,targOff,5
1,20,939.9,545.6,1244,-275,969,1,waiting,5
1,20,1102.7,549.6,421,993,1414,2,targOff,5
1,21,936.9,542.1,1118,-163,955,1,waiting,5
1,21,1108.7,538.6,632,981,1613,2,waiting,5
1,22,931.6,543.6,1247,-5,1242,1,waiting,5
1,22,791.3,545.6,414,1266,1680,2,targOff,5
1,23,937.2,541.8,1449,-285,1164,1,waiting,5
1,23,765,546.3,423,1191,1614,2,targOff,5
1,24,941.2,543.6,1242,-291,951,1,waiting,5
1,24,766.6,543.6,720,977,1697,2,waiting,5
1,25,936,542.6,1278,-272,1006,1,waiting,5
1,25,1097.7,549.5,434,1031,1465,2,targOff,5
1,26,930.3,550,1288,-274,1014,1,waiting,5
1,26,755.3,545.9,458,1039,1497,2,targOff,5
1,27,942.4,543.6,803,-13,790,1,waiting,5
1,27,1116.3,549.7,704,826,1530,2,waiting,5
1,28,931.3,544.9,1601,-277,1324,1,waiting,5
1,28,765.5,539.7,446,1348,1794,2,targOff,5
1,29,933.5,549.2,1049,-31,1018,1,waiting,5
1,29,1085,556.8,238,1043,1281,2,waiting,5
1,29,1123.1,545.7,393,1304,1697,3,targOff,5
1,30,943,547.8,1389,-8,1381,1,waiting,5
1,30,764,546.1,462,1415,1877,2,targOff,5
1,31,922.4,557,390,-283,107,1,waiting,5
1,31,942.7,551.4,1130,116,1246,2,waiting,5
1,31,1101.5,551.6,461,1270,1731,3,targOff,5
1,32,912.6,555.9,296,-281,15,1,waiting,5
1,32,940.2,547.5,952,25,977,2,waiting,5
1,32,1106.7,553.2,428,1003,1431,3,targOff,5
1,33,943.8,543.5,1573,-284,1289,1,waiting,5
1,33,758.8,544.9,459,1322,1781,2,targOff,5
1,34,932.8,544.6,1188,-287,901,1,waiting,5
1,34,1083.6,543.1,154,927,1081,2,waiting,5
1,35,931.6,541,1743,-283,1460,1,waiting,5
1,35,773.9,546.1,278,1486,1764,2,targOff,5
1,36,938.9,539,1361,-281,1080,1,waiting,5
1,36,1105.9,545.6,447,1112,1559,2,targOff,5
1,37,1052.9,524.3,274,406,680,1,waiting,5
1,37,1102.9,536.4,318,712,1030,2,waiting,5
1,38,942.1,552.6,1178,-277,901,1,waiting,5
1,38,1081,558.5,53,924,977,2,waiting,5
1,38,1168.6,562.2,66,1014,1080,3,waiting,5
1,39,934.4,545.3,1589,-286,1303,1,waiting,5
1,39,1094.9,549.9,419,1328,1747,2,targOff,5
1,40,944.3,541.1,1647,-289,1358,1,waiting,5
1,40,775.8,537.9,432,1383,1815,2,targOff,5
1,1,939.6,535.6,1887,5,1892,1,waiting,6
1,2,934.6,537.4,1730,-283,1447,1,waiting,6
1,3,938.9,538.9,1787,-273,1514,1,waiting,6
1,4,937.6,541.9,1970,-273,1697,1,waiting,6
1,5,935.6,534.2,1988,-274,1714,1,waiting,6
1,6,941.4,530.6,1471,-24,1447,1,waiting,6
1,7,926.9,539.5,1497,0,1497,1,waiting,6
1,8,936.1,535.5,1725,-280,1445,1,waiting,6
1,9,925.6,539.1,1703,-272,1431,1,waiting,6
1,10,932.3,540.9,1599,-85,1514,1,waiting,6
1,11,936.9,544.5,1755,-274,1481,1,waiting,6
1,12,935.9,538.1,1871,-106,1765,1,waiting,6
1,13,929.9,539.3,1507,-9,1498,1,waiting,6
1,14,945.6,536.6,2019,-289,1730,1,waiting,6
1,15,993.3,540.5,284,-276,8,1,waiting,6
1,15,933.2,530.7,1628,19,1647,2,waiting,6
1,16,926.8,542.7,2069,-272,1797,1,waiting,6
1,17,935.7,538.5,1456,-26,1430,1,waiting,6
1,18,934.5,535.4,1951,-53,1898,1,waiting,6
1,19,928.2,530.7,1689,-208,1481,1,waiting,6
1,20,930.3,541.5,2004,-274,1730,1,waiting,6
1,21,928.2,541.5,1905,-275,1630,1,waiting,6
1,22,932.1,542.1,1949,-285,1664,1,waiting,6
1,23,923.6,546.1,1870,-273,1597,1,waiting,6
1,24,885.3,570.7,464,-286,178,1,waiting,6
1,24,918.7,547.1,572,192,764,2,waiting,6
1,25,933.9,537.9,488,-281,207,1,waiting,6
1,25,934.7,528.8,486,411,897,2,waiting,6
1,26,923.4,538.1,1948,-284,1664,1,waiting,6
1,27,925.4,541,1863,-282,1581,1,waiting,6
1,28,920.8,538.5,1867,-287,1580,1,waiting,6
1,29,928.3,542.4,1777,-280,1497,1,waiting,6
1,30,926.4,544.9,2043,-279,1764,1,waiting,6
1,31,928.3,547.5,1818,-270,1548,1,waiting,6
1,32,928.3,530.4,1711,-280,1431,1,waiting,6
1,33,932.3,531.1,1714,-283,1431,1,waiting,6
1,34,929.7,540.2,2023,-280,1743,1,waiting,6
1,35,931.7,539.1,1757,-281,1476,1,waiting,6
1,36,932.2,532,2161,-286,1875,1,waiting,6
1,37,933.3,553,2025,-280,1745,1,waiting,6
1,38,925.6,541.3,1818,-287,1531,1,waiting,6
1,39,919.7,540.2,1663,-49,1614,1,waiting,6
1,40,928,540,2095,-281,1814,1,waiting,6
1,1,927.2,537.7,1543,-277,1266,1,waiting,7
1,1,1112.2,555.8,444,1303,1747,2,targOff,7
1,2,935.7,547,1344,-281,1063,1,waiting,7
1,2,837.9,548.7,215,1083,1298,2,waiting,7
1,2,765,549.7,464,1316,1780,3,targOff,7
1,3,934.1,545.2,1197,-181,1016,1,waiting,7
1,3,784,548.5,270,1042,1312,2,targOff,7
1,3,751.5,546.9,90,1324,1414,3,targOff,7
1,4,933.6,551.7,1543,-289,1254,1,waiting,7
1,4,1104.5,548.5,451,1279,1730,2,targOff,7
1,5,931.5,547.7,1626,-280,1346,1,waiting,7
1,5,736.8,539.5,452,1375,1827,2,targOff,7
1,6,932.5,544.7,1354,-44,1310,1,waiting,7
1,6,1115.4,543.5,442,1338,1780,2,targOff,7
1,7,930.6,546.5,1434,-277,1157,1,waiting,7
1,7,758.5,549.4,444,1183,1627,2,targOff,7
1,8,933.2,546.6,1217,-154,1063,1,waiting,7
1,8,1095.6,543,432,1099,1531,2,targOff,7
1,9,885.9,630.1,128,369,497,1,waiting,7
1,9,893.8,567.8,77,517,594,2,waiting,7
1,9,927.4,531.6,138,619,757,3,waiting,7
1,9,941.7,541.4,448,766,1214,4,waiting,7
1,10,937.4,542.4,1322,-166,1156,1,waiting,7
1,10,752.6,546.5,425,1189,1614,2,targOff,7
1,11,928.7,545.9,1314,-287,1027,1,waiting,7
1,11,1099.7,548.1,427,1054,1481,2,targOff,7
1,12,931.9,547.6,1275,7,1282,1,waiting,7
1,12,746.1,546.3,447,1317,1764,2,targOff,7
1,13,940.9,546.5,1499,-12,1487,1,waiting,7
1,13,724.8,542.3,124,1518,1642,2,targOff,7
1,13,768.4,546.1,134,1663,1797,3,targOff,7
1,14,940.3,539.8,1323,-214,1109,1,waiting,7
1,14,1093.5,543.8,310,1138,1448,2,targOff,7
1,15,919.4,539.1,280,-280,0,1,waiting,7
1,15,933,543.9,955,7,962,2,waiting,7
1,15,1132.3,550.1,444,999,1443,3,targOff,7
1,16,930.8,540.9,1537,-281,1256,1,waiting,7
1,16,759.8,540.1,441,1290,1731,2,targOff,7
1,17,926.7,544,1413,-276,1137,1,waiting,7
1,17,1107.8,544.9,383,1164,1547,2,targOff,7
1,18,938.2,547.7,1624,-283,1341,1,waiting,7
1,18,761.4,540.8,449,1366,1815,2,targOff,7
1,19,924.6,545.6,1166,-65,1101,1,waiting,7
1,19,768,552.9,470,1127,1597,2,targOff,7
1,20,937.4,545.7,1542,-280,1262,1,waiting,7
1,20,1092.5,547.6,458,1287,1745,2,targOff,7
1,21,930.2,546.1,1399,8,1407,1,waiting,7
1,21,788.1,547.8,461,1432,1893,2,targOff,7
1,22,932.6,547.7,1253,-271,982,1,waiting,7
1,22,1081.2,547.5,408,1006,1414,2,targOff,7
1,23,926.7,544.5,1337,-280,1057,1,waiting,7
1,23,1098.4,549.3,396,1082,1478,2,targOff,7
1,24,933.3,538.1,1568,-241,1327,1,waiting,7
1,24,775.7,545.9,444,1353,1797,2,targOff,7
1,25,939.3,550.7,1230,-23,1207,1,waiting,7
1,25,750.2,553.1,480,1234,1714,2,targOff,7
1,26,935.4,551.3,1429,-287,1142,1,waiting,7
1,26,1085,548,307,1167,1474,2,waiting,7
1,26,1112.7,549.5,411,1486,1897,3,targOff,7
1,27,933.5,542.1,1229,-285,944,1,waiting,7
1,27,1086.5,544,574,970,1544,2,dotOff,7
1,28,929,551.7,1280,-281,999,1,waiting,7
1,28,750.7,547.5,462,1035,1497,2,targOff,7
1,29,934,540.3,1569,-280,1289,1,waiting,7
1,29,1094.3,544.3,248,1316,1564,2,targOff,7
1,30,927.5,547.5,1345,-280,1065,1,waiting,7
1,30,1100,544.3,458,1090,1548,2,targOff,7
1,31,938.3,555.5,1277,-270,1007,1,waiting,7
1,31,764,559.1,449,1031,1480,2,targOff,7
1,32,935.1,554.1,1245,-27,1218,1,waiting,7
1,32,772,561.9,487,1243,1730,2,targOff,7
1,33,948.7,559.1,1569,-284,1285,1,waiting,7
1,33,804.8,561,79,1309,1388,2,dotOff,7
1,33,730.7,557.8,158,1408,1566,3,targOff,7
1,33,760,563.2,287,1578,1865,4,targOff,7
1,34,942.3,558,1518,-282,1236,1,waiting,7
1,34,1119.2,555,452,1261,1713,2,targOff,7
1,35,949.8,567.9,1115,-21,1094,1,waiting,7
1,35,838,570.3,326,1114,1440,2,dotOff,7
1,35,777.5,570.3,308,1456,1764,3,targOff,7
1,36,948.5,557.3,1316,-285,1031,1,waiting,7
1,36,789.5,559,327,1056,1383,2,waiting,7
1,36,764.2,559.4,438,1393,1831,3,targOff,7
1,37,936.7,546.7,1260,-243,1017,1,waiting,7
1,37,1119.4,547.7,602,1045,1647,2,dotOff,7
1,38,936.1,546.7,1406,-14,1392,1,waiting,7
1,38,1107.1,550.8,447,1417,1864,2,targOff,7
1,39,948.3,554,1360,-279,1081,1,waiting,7
1,39,1103.5,550,301,1106,1407,2,targOff,7
1,39,1124.4,547.6,100,1429,1529,3,targOff,7
1,40,951.4,558.8,1828,-281,1547,1,waiting,7
1,40,1087.8,542,171,1570,1741,2,targOff,7
1,40,1133.3,541.4,105,1756,1861,3,targOff,7
1,1,938.9,545.3,1842,-281,1561,1,waiting,8
1,2,943.2,549.8,1902,-287,1615,1,waiting,8
1,3,935.7,547.3,1772,-274,1498,1,waiting,8
1,4,939.3,551.5,2172,-275,1897,1,waiting,8
1,5,941.2,552.8,1543,3,1546,1,waiting,8
1,6,947.6,558.4,1979,-283,1696,1,waiting,8
1,7,942.5,565.4,181,-164,17,1,waiting,8
1,7,936.3,549.9,1719,28,1747,2,waiting,8
1,8,990.7,581.2,284,-279,5,1,waiting,8
1,8,939.8,551.4,1730,17,1747,2,waiting,8
1,9,953.4,539.6,542,-280,262,1,waiting,8
1,9,939.3,549.3,1459,272,1731,2,waiting,8
1,10,949.6,562.2,1575,-44,1531,1,waiting,8
1,11,935.8,553.3,2177,-279,1898,1,waiting,8
1,12,939.8,553.3,1955,-42,1913,1,waiting,8
1,13,937.5,550.8,2088,-274,1814,1,waiting,8
1,14,927.8,548.2,1777,-280,1497,1,waiting,8
1,15,931.5,589.1,245,360,605,1,waiting,8
1,15,938.3,554.4,573,620,1193,2,waiting,8
1,16,935.1,550.4,1872,-24,1848,1,waiting,8
1,17,932.7,550.5,2205,-274,1931,1,waiting,8
1,18,932.4,551.3,1913,-282,1631,1,waiting,8
1,19,937.4,546.7,1870,-272,1598,1,waiting,8
1,20,935.8,551.5,1786,-272,1514,1,waiting,8
1,21,926,580,317,-283,34,1,waiting,8
1,21,939.4,544.5,1568,46,1614,2,waiting,8
1,22,935.5,535.7,2107,-276,1831,1,waiting,8
1,23,937.2,547.4,1903,-55,1848,1,waiting,8
1,24,940.5,549.3,2150,-286,1864,1,waiting,8
1,25,936.9,549.5,1858,-280,1578,1,waiting,8
1,26,930.8,539.2,1728,-281,1447,1,waiting,8
1,27,937.8,560.6,143,-123,20,1,waiting,8
1,27,934.9,542.3,1519,28,1547,2,waiting,8
1,28,924.9,576.2,1763,-282,1481,1,waiting,8
1,29,931.2,542.9,1791,-281,1510,1,waiting,8
1,30,925.7,533.2,1570,-10,1560,1,waiting,8
1,31,937.6,554.3,1874,-281,1593,1,waiting,8
1,32,935.7,552.4,1915,-1,1914,1,waiting,8
1,33,944.6,551.8,1858,-277,1581,1,waiting,8
1,34,940.6,549,2028,-281,1747,1,waiting,8
1,35,933.1,554.7,2123,-276,1847,1,waiting,8
1,36,899.2,532.8,308,-291,17,1,waiting,8
1,36,929.7,547.3,1518,29,1547,2,waiting,8
1,37,932.3,543.6,1525,-46,1479,1,waiting,8
1,38,934.5,553.6,1625,-31,1594,1,waiting,8
1,39,944.8,549.6,1725,-278,1447,1,waiting,8
1,40,936,550.9,1600,-19,1581,1,waiting,8
1,1,975.3,513.9,1500,-276,1224,1,waiting,9
1,1,1118.2,521.7,531,1250,1781,2,targVis,9
1,2,963.8,528.7,1677,-284,1393,1,waiting,9
1,2,1109.9,524,380,1418,1798,2,targOff,9
1,3,957.8,525,1740,-10,1730,1,waiting,9
1,4,967.6,525.1,1231,-280,951,1,waiting,9
1,4,1112.7,521.3,346,978,1324,2,targOff,9
1,4,1147.1,517.9,145,1336,1481,3,targOff,9
1,5,958,520.6,1666,-281,1385,1,waiting,9
1,5,789.3,528.6,383,1412,1795,2,targOff,9
1,6,957.5,518.9,1263,-281,982,1,waiting,9
1,6,1144.1,522.5,498,1016,1514,2,targOff,9
1,7,960.6,525.2,1331,-284,1047,1,waiting,9
1,7,1135.5,520.1,750,1081,1831,2,waiting,9
1,8,951.7,521.5,1598,-224,1374,1,waiting,9
1,8,787.3,523.2,380,1400,1780,2,targOff,9
1,9,953.8,523.3,1025,-39,986,1,waiting,9
1,9,1138.2,522.1,476,1017,1493,2,targOff,9
1,10,954.4,517.7,932,-36,896,1,waiting,9
1,10,1122.9,523.5,708,923,1631,2,waiting,9
1,11,948.3,539.2,1430,-282,1148,1,waiting,9
1,11,1089.2,534.1,305,1174,1479,2,targOff,9
1,12,954.9,524.4,1286,-286,1000,1,waiting,9
1,12,778.1,521,366,1032,1398,2,targOff,9
1,13,953.9,521.3,881,-32,849,1,waiting,9
1,13,760.7,519.1,166,881,1047,2,waiting,9
1,14,945,523.2,1412,-283,1129,1,waiting,9
1,14,781.6,524.7,357,1156,1513,2,targOff,9
1,15,943.6,546.5,358,-274,84,1,waiting,9
1,15,950.8,525,964,91,1055,2,waiting,9
1,15,1088.4,529.9,533,1081,1614,3,targVis,9
1,16,943.9,539.8,1145,-8,1137,1,waiting,9
1,16,781.6,530.8,418,1162,1580,2,targOff,9
1,17,954.1,528.4,1552,-272,1280,1,waiting,9
1,17,1121.6,539.7,592,1306,1898,2,dotOff,9
1,18,951.7,526.6,1110,-39,1071,1,waiting,9
1,18,770.5,523.8,598,1100,1698,2,dotOff,9
1,19,947.6,528.9,1501,-272,1229,1,waiting,9
1,19,1129.5,530.3,421,1259,1680,2,targOff,9
1,20,948.7,528.5,1169,-38,1131,1,waiting,9
1,20,778.8,527.3,437,1160,1597,2,targOff,9
1,21,948.6,525.5,1320,-275,1045,1,waiting,9
1,21,1142.3,528.5,447,1084,1531,2,targOff,9
1,22,943,526.8,1058,-80,978,1,waiting,9
1,22,778.9,525.3,475,1005,1480,2,targOff,9
1,23,946.7,528.4,1192,-278,914,1,waiting,9
1,23,1096,528,300,941,1241,2,waiting,9
1,23,1137.6,524.1,428,1253,1681,3,targOff,9
1,24,952.6,537.3,1515,-280,1235,1,waiting,9
1,24,1133.1,523,423,1269,1692,2,targOff,9
1,25,952,513.2,1784,-277,1507,1,waiting,9
1,25,1095.1,521.6,339,1539,1878,2,targOff,9
1,26,959.7,524.1,1361,-285,1076,1,waiting,9
1,26,788.7,525.8,362,1102,1464,2,targOff,9
1,27,959.5,516.7,1277,-18,1259,1,waiting,9
1,27,809.3,521.6,392,1284,1676,2,targOff,9
1,28,952.7,519.2,1424,-275,1149,1,waiting,9
1,28,751.4,519.5,423,1180,1603,2,targOff,9
1,29,949.7,522.5,1214,-282,932,1,waiting,9
1,29,799.5,516.3,522,958,1480,2,targVis,9
1,30,953.1,510.9,1459,-273,1186,1,waiting,9
1,30,773,521.5,450,1215,1665,2,targOff,9
1,31,949.2,516,1122,-161,961,1,waiting,9
1,31,1126,523.4,438,989,1427,2,targOff,9
1,32,951.5,512.7,1182,-288,894,1,waiting,9
1,32,1115.2,528.2,260,921,1181,2,waiting,9
1,33,942.6,529.2,928,-290,638,1,waiting,9
1,33,1108.8,528.9,149,665,814,2,waiting,9
1,34,942.6,521.2,1352,-271,1081,1,waiting,9
1,34,1138.3,523,462,1119,1581,2,targOff,9
1,35,951.9,519.6,1414,-45,1369,1,waiting,9
1,35,807.7,523,422,1393,1815,2,targOff,9
1,36,956.4,529.9,1026,-1,1025,1,waiting,9
1,36,1135.7,530.4,466,1062,1528,2,targOff,9
1,37,953.7,527.3,1358,-286,1072,1,waiting,9
1,37,1126.1,534.6,595,1102,1697,2,dotOff,9
1,38,951.3,528.6,1239,-272,967,1,waiting,9
1,38,1099,531.3,523,991,1514,2,targVis,9
1,39,950.8,536.6,1247,-272,975,1,waiting,9
1,39,1135.5,542.6,670,1012,1682,2,waiting,9
1,40,950.4,535.8,1362,-284,1078,1,waiting,9
1,40,776.2,530.5,459,1104,1563,2,targOff,9
1,1,925.9,532.1,291,-281,10,1,waiting,10
1,1,947.9,540.4,1443,19,1462,2,waiting,10
1,2,964.7,533,1998,-284,1714,1,waiting,10
1,3,951,539.6,1850,-269,1581,1,waiting,10
1,4,954.1,535.8,1572,-41,1531,1,waiting,10
1,5,946.2,531.2,2094,-280,1814,1,waiting,10
1,6,958.8,530.8,2111,-280,1831,1,waiting,10
1,7,959.4,529.7,1971,-278,1693,1,waiting,10
1,8,959.3,526.7,1790,-281,1509,1,waiting,10
1,9,944.5,526.4,1733,-286,1447,1,waiting,10
1,10,948.4,532,2012,-282,1730,1,waiting,10
1,11,931.5,533.1,158,-152,6,1,waiting,10
1,11,953.1,539.6,1811,15,1826,2,waiting,10
1,12,949.9,527.1,1495,-64,1431,1,waiting,10
1,13,954.6,532.5,1883,-152,1731,1,waiting,10
1,14,949.7,522,2122,-274,1848,1,waiting,10
1,15,959,530.1,2142,-280,1862,1,waiting,10
1,16,952.6,526.6,1772,-274,1498,1,waiting,10
1,17,956.3,529.4,1714,-22,1692,1,waiting,10
1,18,950.4,530.9,1935,-271,1664,1,waiting,10
1,19,955.3,535.7,1830,-283,1547,1,waiting,10
1,20,953.3,534.4,1854,-23,1831,1,waiting,10
1,21,949.2,535.8,1829,-16,1813,1,waiting,10
1,22,960.4,531.8,1659,4,1663,1,waiting,10
1,23,985,569.9,288,-286,2,1,waiting,10
1,23,994.6,526.6,280,21,301,2,waiting,10
1,23,957.6,532.5,1488,309,1797,3,waiting,10
1,24,952.1,532.3,1850,-20,1830,1,waiting,10
1,25,993.5,534.7,369,-244,125,1,waiting,10
1,25,948.5,529,1445,132,1577,2,waiting,10
1,26,968.8,558.4,285,-279,6,1,waiting,10
1,26,944.7,535.5,1797,13,1810,2,waiting,10
1,27,949.2,532.9,2164,-284,1880,1,waiting,10
1,28,949.7,528.5,1423,-26,1397,1,waiting,10
1,29,948.9,528.1,1679,-16,1663,1,waiting,10
1,30,952.9,533.7,735,179,914,1,waiting,10
1,31,905.3,539.3,308,-271,37,1,waiting,10
1,31,945.3,521.9,1549,50,1599,2,waiting,10
1,32,946.4,526.9,1934,-287,1647,1,waiting,10
1,33,947.2,534.8,1766,-19,1747,1,waiting,10
1,34,948.5,531.8,1681,-129,1552,1,waiting,10
1,35,946.5,525.6,1762,-281,1481,1,waiting,10
1,36,935.5,538.6,1797,-284,1513,1,waiting,10
1,37,948.9,532,1626,-29,1597,1,waiting,10
1,38,945.7,534.3,1931,-284,1647,1,waiting,10
1,39,911.3,523.2,318,-286,32,1,waiting,10
1,39,941.6,533.3,1501,47,1548,2,waiting,10
1,40,821.5,528.2,587,-47,540,1,waiting,10
1,40,859.8,542,588,559,1147,2,waiting,10
1,1,951.7,578.1,298,-191,107,1,waiting,11
1,1,948,557.6,844,187,1031,2,waiting,11
1,2,953.5,549.9,1394,-286,1108,1,waiting,11
1,2,1126.9,556.4,455,1142,1597,2,targOff,11
1,3,949.7,558.7,1289,-287,1002,1,waiting,11
1,3,767.9,547.3,430,1034,1464,2,targOff,11
1,4,946.1,558.6,1237,-287,950,1,waiting,11
1,4,1100.1,560.7,670,977,1647,2,waiting,11
1,5,948.5,555.7,1387,-18,1369,1,waiting,11
1,5,1124.2,558.9,443,1404,1847,2,targOff,11
1,6,946.9,555,1604,-282,1322,1,waiting,11
1,6,777.5,559.9,447,1351,1798,2,targOff,11
1,7,948.4,554.4,1339,-105,1234,1,waiting,11
1,7,771.9,556,470,1260,1730,2,targOff,11
1,8,937.7,555.4,1412,-199,1213,1,waiting,11
1,8,771.4,558.4,468,1246,1714,2,targOff,11
1,9,934.4,560.5,1267,-283,984,1,waiting,11
1,9,783,560.2,436,1012,1448,2,targOff,11
1,10,939.6,551.9,1260,-281,979,1,waiting,11
1,10,781,557.6,531,1003,1534,2,dotOff,11
1,11,932.7,561.9,1381,-272,1109,1,waiting,11
1,11,781,562.3,463,1135,1598,2,targOff,11
1,12,939,560,1170,-74,1096,1,waiting,11
1,12,1112.6,554.6,574,1124,1698,2,dotOff,11
1,13,930.3,557.1,1225,-269,956,1,waiting,11
1,13,1116.3,555.3,124,990,1114,2,waiting,11
1,14,936.1,562.3,1681,-286,1395,1,waiting,11
1,14,764.6,562.6,419,1428,1847,2,targOff,11
1,15,936.2,567.1,1609,-278,1331,1,waiting,11
1,15,782,560.8,440,1358,1798,2,targOff,11
1,16,939.8,564.8,1304,-284,1020,1,waiting,11
1,16,762.1,563.4,450,1047,1497,2,targOff,11
1,17,938.8,562.9,1499,-280,1219,1,waiting,11
1,17,1109.2,567.7,634,1245,1879,2,dotOff,11
1,18,944.5,551.7,1367,-280,1087,1,waiting,11
1,18,773,563.6,429,1117,1546,2,targOff,11
1,19,940,552.7,1240,-274,966,1,waiting,11
1,19,785.6,563.4,437,993,1430,2,targOff,11
1,20,944.1,550,1547,-280,1267,1,waiting,11
1,20,761.7,559,447,1301,1748,2,targOff,11
1,21,944.8,568.2,1337,-276,1061,1,waiting,11
1,21,772.9,567.9,443,1088,1531,2,targOff,11
1,22,938.9,558,1373,-10,1363,1,waiting,11
1,22,1121.3,562.2,403,1395,1798,2,targOff,11
1,23,932.8,558.7,1688,-280,1408,1,waiting,11
1,23,811.9,560.8,416,1431,1847,2,targOff,11
1,24,938,565.9,1158,-50,1108,1,waiting,11
1,24,753.1,569.9,441,1139,1580,2,targOff,11
1,25,937.1,563.1,1429,-270,1159,1,waiting,11
1,25,1118.4,563.1,476,1188,1664,2,targOff,11
1,26,936.9,560.7,1411,-286,1125,1,waiting,11
1,26,1132.8,564.5,704,1161,1865,2,waiting,11
1,27,930.9,558.7,1250,-274,976,1,waiting,11
1,27,755.2,574.1,439,1009,1448,2,targOff,11
1,28,945.2,559.1,1393,-275,1118,1,waiting,11
1,28,1111.4,565.2,452,1145,1597,2,targOff,11
1,29,929.8,559.4,1616,-271,1345,1,waiting,11
1,29,741.7,572.2,440,1374,1814,2,targOff,11
1,30,870,552.3,292,-271,21,1,waiting,11
1,30,920.2,551.1,548,36,584,2,waiting,11
1,30,950.8,559.6,130,595,725,3,waiting,11
1,30,934.3,559.5,1147,734,1881,4,waiting,11
1,31,946.2,557.7,1699,-276,1423,1,waiting,11
1,31,750.4,561.4,450,1459,1909,2,targOff,11
1,32,944,552.9,1294,-284,1010,1,waiting,11
1,32,1101.8,554.3,358,1035,1393,2,waiting,11
1,32,1130,555.3,361,1404,1765,3,targOff,11
1,33,944.7,554.9,1390,-279,1111,1,waiting,11
1,33,767.7,562.3,551,1146,1697,2,dotOff,11
1,34,948.2,552.5,1382,-285,1097,1,waiting,11
1,34,1133.3,557.3,466,1132,1598,2,targOff,11
1,35,945.8,554.5,1245,-274,971,1,waiting,11
1,35,1122.8,559.4,478,1003,1481,2,targOff,11
1,36,949.9,553.4,1076,-283,793,1,waiting,11
1,36,1093.7,556.8,264,817,1081,2,waiting,11
1,36,1127.1,558.7,367,1096,1463,3,targOff,11
1,37,1051.6,543.6,297,-275,22,1,waiting,11
1,37,920.8,549.9,963,46,1009,2,waiting,11
1,38,943.1,560.7,1300,-288,1012,1,waiting,11
1,38,1125.2,564.8,474,1040,1514,2,targOff,11
1,39,944.2,553.3,1330,-283,1047,1,waiting,11
1,39,1126.8,558.9,472,1075,1547,2,targOff,11
1,40,939.4,567.4,875,-15,860,1,waiting,11
1,40,1110.2,561.8,307,894,1201,2,waiting,11
1,40,1135.6,569.6,379,1219,1598,3,targOff,11
1,1,970.2,547.8,226,-6,220,1,waiting,12
1,1,938.7,557.6,1521,227,1748,2,waiting,12
1,2,950.6,563.9,2012,-281,1731,1,waiting,12
1,3,948.8,556.3,2043,-279,1764,1,waiting,12
1,4,944.1,556.5,1652,-88,1564,1,waiting,12
1,5,953.3,550.4,1571,-107,1464,1,waiting,12
1,6,938.6,552.9,1966,-285,1681,1,waiting,12
1,7,940.4,560.6,2167,-286,1881,1,waiting,12
1,8,936,566.4,2074,-277,1797,1,waiting,12
1,9,937.3,564.8,2050,-286,1764,1,waiting,12
1,10,941.4,555,2040,-281,1759,1,waiting,12
1,11,939.1,564.2,1437,-6,1431,1,waiting,12
1,12,936.4,575.7,2173,-279,1894,1,waiting,12
1,13,940.8,558,1551,-87,1464,1,waiting,12
1,14,937.6,552,1922,-61,1861,1,waiting,12
1,15,942.1,568.3,1969,-271,1698,1,waiting,12
1,16,939.9,554.8,2040,-276,1764,1,waiting,12
1,17,872.1,572.2,247,118,365,1,waiting,12
1,17,920.1,557.5,96,386,482,2,waiting,12
1,17,951.7,559.3,496,497,993,3,waiting,12
1,18,942.6,563.7,1936,-277,1659,1,waiting,12
1,19,956.5,606.3,384,-280,104,1,waiting,12
1,19,946,560.8,1461,119,1580,2,waiting,12
1,20,943.7,555.5,1480,-32,1448,1,waiting,12
1,21,942,567.8,2049,-286,1763,1,waiting,12
1,22,939.3,566.2,1518,-37,1481,1,waiting,12
1,23,938.1,557.6,1785,-271,1514,1,waiting,12
1,24,940.5,562.6,2150,-286,1864,1,waiting,12
1,25,943.3,565.6,1914,-283,1631,1,waiting,12
1,26,943.8,567.1,1765,-18,1747,1,waiting,12
1,27,958.8,574.2,283,-275,8,1,waiting,12
1,27,942.5,563.5,1776,17,1793,2,waiting,12
1,28,917.9,571.6,290,-280,10,1,waiting,12
1,28,938.2,557,1756,24,1780,2,waiting,12
1,29,932,557.5,1739,-27,1712,1,waiting,12
1,30,947.6,564.1,1936,-288,1648,1,waiting,12
1,31,985,592.4,476,-283,193,1,waiting,12
1,31,961.6,565.4,136,212,348,2,waiting,12
1,31,937.7,569.1,1238,359,1597,3,waiting,12
1,32,928,564.3,294,-279,15,1,waiting,12
1,32,938.9,569,1796,33,1829,2,waiting,12
1,33,947.7,557.7,1735,-121,1614,1,waiting,12
1,34,949.7,571.3,307,-284,23,1,waiting,12
1,34,940,555,1498,33,1531,2,waiting,12
1,35,944.7,562.7,1815,-34,1781,1,waiting,12
1,36,937.7,562.6,2005,-275,1730,1,waiting,12
1,37,942.6,565.4,1786,-271,1515,1,waiting,12
1,38,940.6,552.2,1721,-273,1448,1,waiting,12
1,39,939.4,563.1,2000,-170,1830,1,waiting,12
1,40,943.6,566,2161,-284,1877,1,waiting,12
1,1,915.5,552.3,297,-274,23,1,waiting,13
1,1,939.8,555.4,1270,35,1305,2,waiting,13
1,1,1132,567.8,467,1330,1797,3,targOff,13
1,2,939.7,559,1054,-60,994,1,waiting,13
1,2,742.9,555.7,130,1031,1161,2,waiting,13
1,3,943.5,588.9,204,340,544,1,waiting,13
1,3,960.5,572.5,131,566,697,2,waiting,13
1,3,936.5,564.1,271,707,978,3,waiting,13
1,4,936.7,567.7,1353,-285,1068,1,waiting,13
1,4,1119.1,567.3,435,1095,1530,2,targOff,13
1,5,945.8,559.2,1341,-286,1055,1,waiting,13
1,5,1135.9,565.1,486,1094,1580,2,targOff,13
1,6,941.6,556.3,1192,-269,923,1,waiting,13
1,6,752.8,552.7,449,949,1398,2,targOff,13
1,7,843.3,543.5,291,-286,5,1,waiting,13
1,7,910.3,546,184,27,211,2,waiting,13
1,7,939.6,555.5,860,218,1078,3,waiting,13
1,7,747,564.5,432,1116,1548,4,targOff,13
1,8,936.5,555.7,1206,-283,923,1,waiting,13
1,8,800,551.2,196,948,1144,2,dotOff,13
1,8,757.5,552.8,392,1155,1547,3,targOff,13
1,9,936.6,571.3,1323,-281,1042,1,waiting,13
1,9,741.9,561.7,444,1070,1514,2,targOff,13
1,10,934.1,567.6,1338,-284,1054,1,waiting,13
1,10,1089.5,577.6,524,1090,1614,2,targVis,13
1,11,917.9,562.6,194,7,201,1,waiting,13
1,11,916.6,569.8,44,297,341,2,waiting,13
1,11,918,563.9,382,398,780,3,waiting,13
1,12,936.6,565.2,1403,-280,1123,1,waiting,13
1,12,775.7,561.8,459,1155,1614,2,targOff,13
1,13,943.4,562.4,1636,-279,1357,1,waiting,13
1,13,1116.2,565.8,448,1382,1830,2,targOff,13
1,14,935.4,561.8,1280,0,1280,1,waiting,13
1,14,755.5,559.3,449,1315,1764,2,targOff,13
1,15,941.9,561.2,747,4,751,1,waiting,13
1,15,1074.3,562,217,774,991,2,waiting,13
1,15,1113.6,560.9,619,1011,1630,3,dotOff,13
1,16,944,564.8,1304,-285,1019,1,waiting,13
1,16,1080.7,564.1,179,1040,1219,2,waiting,13
1,16,1116.2,561.5,475,1240,1715,3,targOff,13
1,17,943.3,560.4,1565,-271,1294,1,waiting,13
1,17,1119.7,556.5,411,1320,1731,2,targOff,13
1,18,964,562,1363,-281,1082,1,waiting,13
1,18,764.9,567.9,414,1116,1530,2,targOff,13
1,19,949.6,557.1,237,210,447,1,waiting,13
1,19,958.6,556.6,558,456,1014,2,waiting,13
1,20,946.5,580.6,1421,-274,1147,1,waiting,13
1,21,951.6,560,1291,-275,1016,1,waiting,13
1,21,1124.5,574.8,454,1043,1497,2,targOff,13
1,22,962.9,553.2,1224,-39,1185,1,waiting,13
1,22,772.2,567.5,442,1222,1664,2,targOff,13
1,23,956.1,585.5,148,-136,12,1,waiting,13
1,23,977.8,571.9,1017,23,1040,2,waiting,13
1,23,778.1,562.4,408,1077,1485,3,targOff,13
1,23,866.2,563.3,39,1508,1547,4,targOff,13
1,24,909.6,545.7,345,-280,65,1,waiting,13
1,24,936.1,546,153,88,241,2,waiting,13
1,25,947.5,571,1419,-281,1138,1,waiting,13
1,25,754.7,562.8,455,1175,1630,2,targOff,13
1,26,941.8,563.7,1263,-279,984,1,waiting,13
1,26,1117.2,574.7,447,1014,1461,2,targOff,13
1,27,948.3,567.4,1362,-99,1263,1,waiting,13
1,27,763,560.9,457,1289,1746,2,targOff,13
1,28,942.8,574.1,1327,-278,1049,1,waiting,13
1,28,794.7,562.4,297,1074,1371,2,waiting,13
1,28,758.7,569.7,429,1385,1814,3,targOff,13
1,29,943.9,571.9,1402,-285,1117,1,waiting,13
1,29,782.7,562.3,473,1142,1615,2,targOff,13
1,30,942.6,562.2,1218,-281,937,1,waiting,13
1,30,1120.9,562,480,963,1443,2,targOff,13
1,31,952,568,1162,-36,1126,1,waiting,13
1,31,760.3,570.8,444,1154,1598,2,targOff,13
1,32,963.8,557.5,155,-148,7,1,waiting,13
1,32,942.1,563.3,1264,20,1284,2,waiting,13
1,32,754.8,567,454,1310,1764,3,targOff,13
1,33,940.6,564.1,1333,-271,1062,1,waiting,13
1,33,1101.7,568.6,445,1086,1531,2,targOff,13
1,34,946.3,561.6,1209,-279,930,1,waiting,13
1,34,1116.7,566.6,448,966,1414,2,targOff,13
1,35,945.1,571,1434,-282,1152,1,waiting,13
1,35,1113.1,564,478,1186,1664,2,targOff,13
1,36,949.6,567.1,1691,-287,1404,1,waiting,13
1,36,1113.2,561.9,436,1429,1865,2,targOff,13
1,37,944.2,566.5,1313,-284,1029,1,waiting,13
1,37,753,572,421,1057,1478,2,targOff,13
1,38,942.5,568.4,1097,7,1104,1,waiting,13
1,38,754.4,573.1,425,1139,1564,2,targOff,13
1,39,907.4,540.2,345,-287,58,1,waiting,13
1,39,940.1,568.4,1241,66,1307,2,waiting,13
1,39,769.7,571,543,1337,1880,3,targVis,13
1,40,938.1,573.3,1225,-287,938,1,waiting,13
1,40,1125.4,577.3,472,975,1447,2,targOff,13
1,1,946.1,566.5,2018,-271,1747,1,waiting,14
1,2,940.6,565.3,1490,-26,1464,1,waiting,14
1,3,941.5,559.5,2149,-285,1864,1,waiting,14
1,4,940,560.3,1465,-34,1431,1,waiting,14
1,5,939.1,552.9,1923,-275,1648,1,waiting,14
1,6,938.6,562.4,1820,-272,1548,1,waiting,14
1,7,944.5,554.2,2074,-279,1795,1,waiting,14
1,8,939.7,554.9,2067,-286,1781,1,waiting,14
1,9,959.4,548.1,321,-273,48,1,waiting,14
1,9,937.8,560.4,1741,56,1797,2,waiting,14
1,10,937.8,560.4,2156,-280,1876,1,waiting,14
1,11,935.3,564,1703,-58,1645,1,waiting,14
1,12,945.9,556.2,1749,-18,1731,1,waiting,14
1,13,941,564.3,1679,-282,1397,1,waiting,14
1,14,942.1,567.5,1887,-23,1864,1,waiting,14
1,15,940.1,551.4,1938,-273,1665,1,waiting,14
1,16,939.4,560.8,1744,-35,1709,1,waiting,14
1,17,935.2,564.6,1929,-282,1647,1,waiting,14
1,18,933.9,561.7,1555,-58,1497,1,waiting,14
1,19,962.3,556.1,316,-288,28,1,waiting,14
1,19,944.5,563.2,1776,38,1814,2,waiting,14
1,20,931.6,564.9,2146,-282,1864,1,waiting,14
1,21,933.7,569.3,1858,-44,1814,1,waiting,14
1,22,931.9,581.1,906,-12,894,1,waiting,14
1,23,941.1,568.9,1865,-284,1581,1,waiting,14
1,24,932.6,573.6,1737,-273,1464,1,waiting,14
1,25,934.3,578.1,1590,-10,1580,1,waiting,14
1,26,932.7,568.2,2031,-283,1748,1,waiting,14
1,27,927.7,565.5,1739,-25,1714,1,waiting,14
1,28,932.4,562.4,1763,-16,1747,1,waiting,14
1,29,957.8,592.3,248,-248,0,1,waiting,14
1,29,929.9,562.7,1400,14,1414,2,waiting,14
1,30,985,602.2,181,-171,10,1,waiting,14
1,30,932.2,564.9,1753,27,1780,2,waiting,14
1,31,928.1,566.9,1485,-38,1447,1,waiting,14
1,32,936,566.7,861,170,1031,1,waiting,14
1,33,929.6,565.8,1759,-280,1479,1,waiting,14
1,34,933.8,571.8,1748,-51,1697,1,waiting,14
1,35,935.1,572.1,1444,-13,1431,1,waiting,14
1,36,936.9,561,1455,5,1460,1,waiting,14
1,37,932.7,566.5,1806,-279,1527,1,waiting,14
1,38,933.2,565.9,1917,-53,1864,1,waiting,14
1,39,922.1,558.8,213,-136,77,1,waiting,14
1,39,958.2,567.8,183,93,276,2,waiting,14
1,39,1007.8,561,191,294,485,3,waiting,14
1,39,940.5,559.8,1214,499,1713,4,waiting,14
1,40,933.5,560.2,2171,-273,1898,1,waiting,14
1,1,929.2,559,1000,-5,995,1,waiting,15
1,1,771.9,558.7,402,1029,1431,2,targOff,15
1,2,932.4,562.8,1449,-162,1287,1,waiting,15
1,2,751.1,562.6,478,1319,1797,2,targOff,15
1,3,927.4,566.4,1078,-8,1070,1,waiting,15
1,3,764.5,560.2,496,1101,1597,2,targOff,15
1,4,928.8,568.8,1618,13,1631,1,waiting,15
1,5,937.1,571.3,1424,-273,1151,1,waiting,15
1,5,782.8,567.8,456,1175,1631,2,targOff,15
1,6,931.4,555.2,1054,-86,968,1,waiting,15
1,6,1089.2,557.8,266,991,1257,2,waiting,15
1,6,1122.1,566.2,434,1280,1714,3,targOff,15
1,7,982,570.1,286,-281,5,1,waiting,15
1,7,936.1,568.2,760,23,783,2,waiting,15
1,7,758.4,565.6,85,809,894,3,waiting,15
1,8,937,571,1585,-286,1299,1,waiting,15
1,8,763.4,565.6,456,1325,1781,2,targOff,15
1,9,937.1,571.2,1270,-20,1250,1,waiting,15
1,9,1118.5,569.6,477,1286,1763,2,targOff,15
1,10,939.2,568.4,1318,-286,1032,1,waiting,15
1,10,769.2,564.5,475,1055,1530,2,targOff,15
1,11,931.4,572.3,1236,-275,961,1,waiting,15
1,11,1106.8,573.5,450,998,1448,2,targOff,15
1,12,930.2,562.1,1354,-285,1069,1,waiting,15
1,12,755,562.5,451,1096,1547,2,targOff,15
1,13,936.9,569,1259,-274,985,1,waiting,15
1,13,764.3,565.5,444,1020,1464,2,targOff,15
1,14,922,581.2,221,-179,42,1,waiting,15
1,14,928.3,570.5,1288,62,1350,2,waiting,15
1,14,759.1,565.2,444,1387,1831,3,targOff,15
1,15,933,572.7,1623,-281,1342,1,waiting,15
1,15,1107.7,567.2,497,1367,1864,2,targOff,15
1,16,911,557.2,168,-166,2,1,waiting,15
1,16,933.2,569,1225,23,1248,2,waiting,15
1,16,750.2,571.8,446,1285,1731,3,targOff,15
1,17,934.8,566,1133,13,1146,1,waiting,15
1,17,772.9,560.2,616,1181,1797,2,dotOff,15
1,18,941.6,562.8,1293,-284,1009,1,waiting,15
1,18,1101.3,568.7,801,1046,1847,2,waiting,15
1,19,930,564.1,1445,-185,1260,1,waiting,15
1,19,1091.9,569.7,287,1288,1575,2,targOff,15
1,19,1125.4,563,89,1592,1681,3,targOff,15
1,20,937.7,564.8,1500,-281,1219,1,waiting,15
1,20,1135.7,569,434,1246,1680,2,targOff,15
1,21,943.4,565.7,1265,-173,1092,1,waiting,15
1,21,1035.6,565,159,1115,1274,2,dotOff,15
1,21,1112.2,566.8,401,1297,1698,3,targOff,15
1,22,936.6,570.6,1306,-289,1017,1,waiting,15
1,22,1071.4,570,265,1041,1306,2,waiting,15
1,22,1110.7,576.7,418,1329,1747,3,targOff,15
1,23,963.4,567.4,175,-137,38,1,waiting,15
1,23,937.5,570.6,1045,48,1093,2,waiting,15
1,23,1122.3,572.4,326,1118,1444,3,targOff,15
1,24,939.5,564.2,1483,-286,1197,1,waiting,15
1,24,751.7,554.3,475,1223,1698,2,targOff,15
1,25,942.9,562.6,1006,6,1012,1,waiting,15
1,25,1089.1,572.9,639,1037,1676,2,dotOff,15
1,26,937.8,562.5,967,-13,954,1,waiting,15
1,26,1093.7,569.2,675,981,1656,2,waiting,15
1,27,936.8,561.8,1353,-280,1073,1,waiting,15
1,27,1132.6,563.5,481,1099,1580,2,targOff,15
1,28,947,574.7,1680,-287,1393,1,waiting,15
1,28,1108.1,571.9,480,1418,1898,2,targOff,15
1,29,940.9,559.3,1264,2,1266,1,waiting,15
1,29,1100.2,572.3,203,1290,1493,2,targVis,15
1,29,1119.4,570.7,301,1512,1813,3,targOff,15
1,30,939.8,559.1,1527,-285,1242,1,waiting,15
1,30,750.6,561.3,450,1280,1730,2,targOff,15
1,31,932.9,571.1,1525,-280,1245,1,waiting,15
1,31,1106.7,564.4,446,1284,1730,2,targOff,15
1,32,938.5,557.5,1226,-276,950,1,waiting,15
1,32,762.7,559.9,158,985,1143,2,waiting,15
1,33,905.4,559.8,296,-283,13,1,waiting,15
1,33,936.4,561.2,665,30,695,2,waiting,15
1,33,1092.8,564.2,186,720,906,3,waiting,15
1,33,1128.1,567.8,314,933,1247,4,waiting,15
1,34,938.3,565.6,1632,-281,1351,1,waiting,15
1,34,768.7,566.2,456,1375,1831,2,targOff,15
1,35,943.1,557.5,1426,-279,1147,1,waiting,15
1,35,761.6,562.9,449,1183,1632,2,targOff,15
1,36,941.3,564.1,1552,-280,1272,1,waiting,15
1,36,1096.1,567.7,467,1297,1764,2,targOff,15
1,37,934.7,564.9,1266,-275,991,1,waiting,15
1,37,1093.6,561.1,463,1017,1480,2,targOff,15
1,38,932.9,566.5,1799,-285,1514,1,waiting,15
1,39,943,558.3,1688,-281,1407,1,waiting,15
1,39,775.5,561.9,421,1442,1863,2,targOff,15
1,40,934.8,560.8,1694,-291,1403,1,waiting,15
1,40,1123.1,570.2,431,1433,1864,2,targOff,15
1,1,952.4,551.6,1991,-280,1711,1,waiting,16
1,2,940.6,554.1,1557,7,1564,1,waiting,16
1,3,948.2,551,1560,-13,1547,1,waiting,16
1,4,950.3,556.1,2043,-280,1763,1,waiting,16
1,5,948.6,553.2,1956,-113,1843,1,waiting,16
1,6,943.6,550.4,1501,-58,1443,1,waiting,16
1,7,943.8,561.6,1953,-273,1680,1,waiting,16
1,8,947.6,553.1,1754,-277,1477,1,waiting,16
1,9,950.5,556.9,2106,-277,1829,1,waiting,16
1,10,932.9,557.1,1994,-280,1714,1,waiting,16
1,11,941.5,551,1660,-46,1614,1,waiting,16
1,12,946.2,555,2046,-282,1764,1,waiting,16
1,13,950.2,549.9,1829,1,1830,1,waiting,16
1,14,946,551.1,1778,-281,1497,1,waiting,16
1,15,940.7,542.1,2009,-280,1729,1,waiting,16
1,16,936.1,545.6,101,-27,74,1,waiting,16
1,16,950,552.4,1279,85,1364,2,waiting,16
1,16,1006.4,555.3,114,1380,1494,3,targOff,16
1,17,946.5,548.1,1484,-5,1479,1,waiting,16
1,18,943.4,552.3,1761,-278,1483,1,waiting,16
1,18,1010,551.3,27,1500,1527,2,targOff,16
1,19,982.1,556.6,148,-114,34,1,waiting,16
1,19,949.6,546.4,1718,45,1763,2,waiting,16
1,20,953.8,543.7,1877,-281,1596,1,waiting,16
1,21,945.5,548.6,2056,-280,1776,1,waiting,16
1,22,941.9,550.8,544,-271,273,1,waiting,16
1,22,930.6,556.6,612,419,1031,2,waiting,16
1,23,937.6,552,1892,-279,1613,1,waiting,16
1,24,935.6,553.4,275,7,282,1,waiting,16
1,24,937.5,553.8,572,405,977,2,waiting,16
1,25,942.8,553.2,1966,-285,1681,1,waiting,16
1,26,939,549,2200,-286,1914,1,waiting,16
1,27,942,552.4,2068,-271,1797,1,waiting,16
1,28,933,554.2,1941,-277,1664,1,waiting,16
1,29,941.1,557.3,1916,-52,1864,1,waiting,16
1,30,938.2,551.2,1493,-45,1448,1,waiting,16
1,31,939.9,549,1771,-289,1482,1,waiting,16
1,32,939.1,551.1,1824,-278,1546,1,waiting,16
1,33,935.9,558,2098,-288,1810,1,waiting,16
1,34,967.3,554.8,296,-276,20,1,waiting,16
1,34,940.2,553.3,1518,29,1547,2,waiting,16
1,35,927.1,555.7,1828,-18,1810,1,waiting,16
1,36,936.9,556.2,1906,-277,1629,1,waiting,16
1,37,937.1,551.5,913,-281,632,1,waiting,16
1,37,937.6,558.9,852,642,1494,2,waiting,16
1,38,930.5,560.3,1824,-277,1547,1,waiting,16
1,39,948,541.4,290,-276,14,1,waiting,16
1,39,938.6,552.4,1821,22,1843,2,waiting,16
1,40,948.4,573.9,446,-277,169,1,waiting,16
1,40,938.2,560.2,904,294,1198,2,waiting,16
1,1,952.4,541.1,299,-289,10,1,waiting,17
1,1,930.9,553.5,1147,19,1166,2,waiting,17
1,1,1113.1,557.2,454,1193,1647,3,targOff,17
1,2,939,550.4,1211,-281,930,1,waiting,17
1,2,1102.8,559.6,573,957,1530,2,dotOff,17
1,3,934.1,550.2,1283,-280,1003,1,waiting,17
1,3,1101.3,552,665,1033,1698,2,waiting,17
1,4,938.9,550.4,1340,-276,1064,1,waiting,17
1,4,772.8,548.5,655,1090,1745,2,dotOff,17
1,5,937.4,551.1,1465,-285,1180,1,waiting,17
1,5,754.2,550.7,419,1212,1631,2,targOff,17
1,6,951.3,550,1194,-287,907,1,waiting,17
1,6,1126.7,554.5,540,941,1481,2,targVis,17
1,7,951.2,557.1,99,-50,49,1,waiting,17
1,7,942.2,550.1,558,239,797,2,waiting,17
1,8,958.4,550.6,1462,-275,1187,1,waiting,17
1,8,779,556.3,410,1221,1631,2,targOff,17
1,9,941.1,553.1,1162,-272,890,1,waiting,17
1,9,801.9,547.4,70,918,988,2,dotOff,17
1,9,721.6,548.3,139,1008,1147,3,targOff,17
1,9,764.6,542.2,338,1159,1497,4,targOff,17
1,10,941.3,553.6,1271,-286,985,1,waiting,17
1,10,1099.6,555.1,403,1011,1414,2,targOff,17
1,11,945.2,558.9,1051,-14,1037,1,waiting,17
1,11,1113.6,549.4,600,1064,1664,2,waiting,17
1,12,944.8,546.1,1270,-290,980,1,waiting,17
1,12,1118.6,562.1,423,1006,1429,2,targOff,17
1,13,928.1,576.6,1032,-37,995,1,waiting,17
1,13,1094.8,570,392,1022,1414,2,targOff,17
1,14,945.8,558.7,848,8,856,1,waiting,17
1,14,804.8,537.8,169,881,1050,2,dotOff,17
1,14,766.4,550.8,418,1062,1480,3,targOff,17
1,15,946.4,549.8,1204,-239,965,1,waiting,17
1,15,1065.3,549.9,96,989,1085,2,targVis,17
1,15,1126.4,551.4,410,1105,1515,3,targOff,17
1,16,934.4,566.2,1684,-274,1410,1,waiting,17
1,16,745.3,555.6,241,1440,1681,2,targOff,17
1,17,935.3,556.6,1319,-270,1049,1,waiting,17
1,17,1101.8,557.1,440,1075,1515,2,targOff,17
1,18,940.2,548.2,1309,-278,1031,1,waiting,17
1,18,779.4,555.4,350,1057,1407,2,waiting,17
1,18,749.6,555.2,325,1418,1743,3,targOff,17
1,19,942.2,548.5,1332,-183,1149,1,waiting,17
1,19,1116.7,554.8,405,1175,1580,2,targOff,17
1,20,950.2,543.3,277,-275,2,1,waiting,17
1,20,940.5,550.6,1133,9,1142,2,waiting,17
1,20,752.6,556.4,370,1177,1547,3,targOff,17
1,21,945.9,553.6,1517,-280,1237,1,waiting,17
1,21,775.3,552.8,599,1265,1864,2,dotOff,17
1,22,943.9,558.3,1512,-287,1225,1,waiting,17
1,22,754,560,429,1252,1681,2,targOff,17
1,23,940.4,552.4,1586,-278,1308,1,waiting,17
1,23,767.2,553.3,232,1335,1567,2,targOff,17
1,23,740,555,153,1577,1730,3,targOff,17
1,24,925,557.1,185,-148,37,1,waiting,17
1,24,945.5,558.8,1021,46,1067,2,waiting,17
1,24,765.2,552.3,420,1094,1514,3,targOff,17
1,25,945.9,547.3,1262,-277,985,1,waiting,17
1,25,805.3,549.4,171,1009,1180,2,waiting,17
1,25,751,552.9,581,1196,1777,3,dotOff,17
1,26,940.7,554,1191,-288,903,1,waiting,17
1,26,1107.8,551.6,167,930,1097,2,waiting,17
1,27,937.8,556.9,1434,-16,1418,1,waiting,17
1,27,1116.6,556.6,420,1445,1865,2,targOff,17
1,28,946.6,554.1,1695,-281,1414,1,waiting,17
1,28,745.7,562,332,1447,1779,2,targOff,17
1,29,972.5,548.6,211,-191,20,1,waiting,17
1,29,946.9,560.9,940,31,971,2,waiting,17
1,29,1114.7,569.1,398,998,1396,3,targOff,17
1,30,943,563.9,1663,-288,1375,1,waiting,17
1,30,770.7,573.2,424,1406,1830,2,targOff,17
1,31,935.1,552.3,1404,-281,1123,1,waiting,17
1,31,759.9,547.8,387,1158,1545,2,targOff,17
1,32,948.9,547.7,141,-124,17,1,waiting,17
1,32,925.1,543.2,1139,25,1164,2,waiting,17
1,32,1090.2,551.6,422,1191,1613,3,targOff,17
1,33,947.2,554.1,1445,-272,1173,1,waiting,17
1,33,754.4,552.3,424,1207,1631,2,targOff,17
1,34,940.2,542.6,1270,-220,1050,1,waiting,17
1,34,759.2,554.4,420,1077,1497,2,targOff,17
1,35,956.5,546.9,289,-284,5,1,waiting,17
1,35,925.5,549.2,1024,16,1040,2,waiting,17
1,35,1085.1,554.8,399,1065,1464,3,targOff,17
1,36,928.9,556,1865,-273,1592,1,waiting,17
1,36,1117.7,560.3,251,1630,1881,2,targOff,17
1,37,932.7,548.5,1263,-273,990,1,waiting,17
1,37,1106.4,562,146,1017,1163,2,waiting,17
1,38,932.6,558.9,1647,-279,1368,1,waiting,17
1,38,746.8,561.5,383,1397,1780,2,targOff,17
1,39,939,561.6,1487,-284,1203,1,waiting,17
1,39,1094.4,559.7,418,1229,1647,2,targOff,17
1,40,925.5,568,1691,-282,1409,1,waiting,17
1,40,1093.8,568,424,1440,1864,2,targOff,17
1,1,986.1,553.3,308,-288,20,1,waiting,18
1,1,963.5,552.2,1734,31,1765,2,waiting,18
1,2,965.1,553.8,2062,-280,1782,1,waiting,18
1,3,966.3,555.9,1813,-282,1531,1,waiting,18
1,4,972.2,551.9,370,-278,92,1,waiting,18
1,4,954.5,550.6,141,99,240,2,waiting,18
1,4,968.3,558.7,1277,249,1526,3,waiting,18
1,5,966.6,555.5,2072,-274,1798,1,waiting,18
1,6,964.2,555.5,1418,-6,1412,1,waiting,18
1,6,964.7,574.1,55,1509,1564,2,targOff,18
1,7,971.7,538.7,1949,-284,1665,1,waiting,18
1,8,970.2,546.8,2097,-282,1815,1,waiting,18
1,9,955.5,544.8,2052,-271,1781,1,waiting,18
1,10,980.8,535.4,295,-271,24,1,waiting,18
1,10,971.3,541.7,1449,32,1481,2,waiting,18
1,11,966.7,544.2,1962,-281,1681,1,waiting,18
1,12,966.1,538.5,1806,-275,1531,1,waiting,18
1,13,964.5,540,1798,-283,1515,1,waiting,18
1,14,976.7,545.1,306,-29,277,1,waiting,18
1,14,952.5,549.8,1296,285,1581,2,waiting,18
1,15,995.8,541.8,117,-110,7,1,waiting,18
1,15,970.5,540.9,1556,21,1577,2,waiting,18
1,16,974.9,538.7,1533,-1,1532,1,waiting,18
1,17,968.6,538.8,1668,-270,1398,1,waiting,18
1,18,964.1,545.8,2112,-281,1831,1,waiting,18
1,19,964.4,543,1887,-273,1614,1,waiting,18
1,20,966.3,535.3,2059,-281,1778,1,waiting,18
1,21,971.9,538.8,1904,-273,1631,1,waiting,18
1,22,960.3,550,1814,-283,1531,1,waiting,18
1,23,967.7,556.2,1774,-277,1497,1,waiting,18
1,24,972.2,572.3,408,-13,395,1,waiting,18
1,25,940.3,539.9,167,-162,5,1,waiting,18
1,25,962.6,547,1421,24,1445,2,waiting,18
1,25,788.7,538.8,148,1479,1627,3,targOff,18
1,26,963.2,543.8,1202,-17,1185,1,waiting,18
1,26,743.5,550.8,25,1222,1247,2,targOff,18
1,26,806,544.7,132,1265,1397,3,targOff,18
1,27,965.4,549.2,1765,-285,1480,1,waiting,18
1,28,975.9,544.5,285,-275,10,1,waiting,18
1,28,963.4,546.8,1644,19,1663,2,waiting,18
1,29,960.6,553.8,1778,-281,1497,1,waiting,18
1,30,959.2,551.1,2094,-281,1813,1,waiting,18
1,31,964.7,547.3,1957,-276,1681,1,waiting,18
1,32,968.3,550.5,1872,-24,1848,1,waiting,18
1,33,965.9,550.1,1906,-280,1626,1,waiting,18
1,34,955.7,534.7,275,-275,0,1,waiting,18
1,34,958.4,552.3,1461,19,1480,2,waiting,18
1,35,969.3,556.4,1843,-281,1562,1,waiting,18
1,36,967.6,533.9,297,-280,17,1,waiting,18
1,36,965.1,545.2,1437,25,1462,2,waiting,18
1,37,970.1,540.7,1470,-40,1430,1,waiting,18
1,38,968.9,548.5,1536,-6,1530,1,waiting,18
1,39,961.6,547.6,1800,-286,1514,1,waiting,18
1,40,964.9,547.4,2095,-281,1814,1,waiting,18
1,1,959.2,544,1506,-272,1234,1,waiting,19
1,1,793.1,537.4,420,1261,1681,2,targOff,19
1,2,968.2,545.5,1279,-284,995,1,waiting,19
1,2,1117.2,545.6,647,1018,1665,2,dotOff,19
1,3,965.6,551.1,1565,-277,1288,1,waiting,19
1,3,1126.7,551.4,375,1322,1697,2,targOff,19
1,4,966.7,551.2,1664,-281,1383,1,waiting,19
1,4,789.6,547.1,437,1409,1846,2,targOff,19
1,5,969.4,537.6,1278,-283,995,1,waiting,19
1,5,780.8,546.3,443,1021,1464,2,targOff,19
1,6,970.4,542.1,1041,-22,1019,1,waiting,19
1,6,775,538.9,425,1056,1481,2,targOff,19
1,7,958.8,549.6,1108,-109,999,1,waiting,19
1,7,794,543.2,438,1026,1464,2,targOff,19
1,8,965.4,542.4,1053,-281,772,1,waiting,19
1,8,793.9,533.3,146,801,947,2,waiting,19
1,9,962.4,545.5,1144,-23,1121,1,waiting,19
1,9,793.6,542.5,434,1147,1581,2,targOff,19
1,10,970.4,545.5,1429,-281,1148,1,waiting,19
1,10,790.3,536.5,446,1185,1631,2,targOff,19
1,11,970.2,544.4,1060,-48,1012,1,waiting,19
1,11,775.5,548.6,674,1039,1713,2,waiting,19
1,12,968.6,545.9,1218,5,1223,1,waiting,19
1,12,1130.1,539.5,446,1247,1693,2,targOff,19
1,13,964.8,548.2,1472,-281,1191,1,waiting,19
1,13,1124.2,543.4,463,1216,1679,2,targOff,19
1,14,972.6,556.2,1290,-280,1010,1,waiting,19
1,14,774.4,544.5,421,1044,1465,2,targOff,19
1,15,963.3,541.5,1651,-280,1371,1,waiting,19
1,15,781.4,542,450,1396,1846,2,targOff,19
1,16,965.8,546.8,1456,-281,1175,1,waiting,19
1,16,1092,546.4,549,1198,1747,2,dotOff,19
1,17,975.1,543.4,1245,-188,1057,1,waiting,19
1,17,1134.4,546.1,483,1081,1564,2,targOff,19
1,18,969,544.2,1491,-276,1215,1,waiting,19
1,18,808.2,538,399,1248,1647,2,targOff,19
1,19,961.9,543.5,1269,-41,1228,1,waiting,19
1,19,1124.2,546.5,469,1262,1731,2,targOff,19
1,20,964.7,557.9,1178,-26,1152,1,waiting,19
1,20,790.4,549.6,443,1188,1631,2,targOff,19
1,21,965,554.5,1231,-280,951,1,waiting,19
1,21,1116.8,550,656,975,1631,2,dotOff,19
1,22,954.3,546.7,1318,-277,1041,1,waiting,19
1,22,804.9,550.1,376,1069,1445,2,targOff,19
1,23,961,544.2,1447,-43,1404,1,waiting,19
1,23,787.4,537.9,484,1430,1914,2,targOff,19
1,24,966,550.7,1160,-72,1088,1,waiting,19
1,24,1112.8,551.9,302,1111,1413,2,waiting,19
1,24,1131.7,554.5,226,1432,1658,3,targOff,19
1,24,1065.5,547.2,105,1676,1781,4,targOff,19
1,25,968.7,547.2,1508,-284,1224,1,waiting,19
1,25,779.6,539,474,1257,1731,2,targOff,19
1,26,968.8,549.6,1257,-273,984,1,waiting,19
1,26,1100.4,548.8,575,1006,1581,2,dotOff,19
1,27,968.7,544.1,1223,3,1226,1,waiting,19
1,27,795.5,539.4,495,1252,1747,2,targOff,19
1,28,952.7,548.3,1305,-279,1026,1,waiting,19
1,28,787.6,536.7,413,1051,1464,2,targOff,19
1,29,969.4,545.3,1115,-282,833,1,waiting,19
1,29,1120.5,546.9,338,859,1197,2,waiting,19
1,30,962.3,558.1,1382,-84,1298,1,waiting,19
1,30,1103.1,546,444,1321,1765,2,targOff,19
1,31,966,550.8,1695,-285,1410,1,waiting,19
1,31,1128.2,538.6,462,1436,1898,2,targOff,19
1,32,973.4,547.7,1682,-271,1411,1,waiting,19
1,32,795.1,545.7,423,1441,1864,2,targOff,19
1,33,966.4,545.3,1036,-17,1019,1,waiting,19
1,33,1131.8,550.7,646,1046,1692,2,dotOff,19
1,34,961.7,538,1389,-283,1106,1,waiting,19
1,34,1085.4,545.2,265,1129,1394,2,dotOff,19
1,34,1146.3,547.7,351,1413,1764,3,targOff,19
1,35,965.6,547.4,1177,-67,1110,1,waiting,19
1,35,837.7,544.2,141,1137,1278,2,targVis,19
1,35,787.6,545.4,388,1293,1681,3,targOff,19
1,36,963.2,551.5,1351,-282,1069,1,waiting,19
1,36,770.7,527,504,1107,1611,2,targOff,19
1,37,959.3,550.3,1073,-48,1025,1,waiting,19
1,37,783.8,537,421,1059,1480,2,targOff,19
1,38,962.8,544.8,1225,-270,955,1,waiting,19
1,38,1129.2,554.9,484,980,1464,2,targOff,19
1,39,965.3,544.2,986,-26,960,1,waiting,19
1,39,1138.2,546.3,504,989,1493,2,targOff,19
1,40,965.7,549,1266,-272,994,1,waiting,19
1,40,802.6,536.9,411,1019,1430,2,targOff,19
1,1,704.9,532.2,324,-280,44,1,waiting,20
1,1,959.3,541.8,808,88,896,2,waiting,20
1,2,964.9,547.2,1917,-286,1631,1,waiting,20
1,3,984.4,547.1,307,-285,22,1,waiting,20
1,3,958.8,552.7,1657,40,1697,2,waiting,20
1,4,964.5,551.5,2170,-272,1898,1,waiting,20
1,5,961.3,556.6,1820,-272,1548,1,waiting,20
1,6,965.3,553,1923,-276,1647,1,waiting,20
1,7,968,550.7,1794,-280,1514,1,waiting,20
1,8,971.2,538.5,1719,-39,1680,1,waiting,20
1,9,973.8,545.2,1922,-8,1914,1,waiting,20
1,10,966.5,544.1,1620,-6,1614,1,waiting,20
1,11,958.4,550.6,1940,-42,1898,1,waiting,20
1,12,960.2,542.4,1872,-274,1598,1,waiting,20
1,13,957.1,544.9,1655,9,1664,1,waiting,20
1,14,964.5,554.9,1481,-17,1464,1,waiting,20
1,15,967.9,540.5,1733,-69,1664,1,waiting,20
1,16,964.7,549.5,1772,-275,1497,1,waiting,20
1,17,966.8,554.4,1823,-275,1548,1,waiting,20
1,18,957.4,544.3,1866,-286,1580,1,waiting,20
1,19,961.4,542.7,1499,-18,1481,1,waiting,20
1,20,953.6,561,285,-285,0,1,waiting,20
1,20,961.9,550.3,1604,10,1614,2,waiting,20
1,21,967.3,541.6,1909,-298,1611,1,waiting,20
1,22,964.6,543.9,1813,18,1831,1,waiting,20
1,23,972.3,544.3,1551,-37,1514,1,waiting,20
1,24,966,542.9,1972,-45,1927,1,waiting,20
1,25,957.6,559.2,1705,-275,1430,1,waiting,20
1,26,993.6,593.1,898,-277,621,1,waiting,20
1,26,1010.9,560,1185,645,1830,2,waiting,20
1,27,905.3,552.8,333,-280,53,1,waiting,20
1,27,965.3,551.3,248,72,320,2,waiting,20
1,27,954,545.9,1064,331,1395,3,waiting,20
1,28,960.5,547.4,1802,-271,1531,1,waiting,20
1,29,954.8,545.1,2037,-123,1914,1,waiting,20
1,30,956.5,532.1,1722,-278,1444,1,waiting,20
1,31,959.5,543.3,2136,-272,1864,1,waiting,20
1,32,945.4,528.9,205,-28,177,1,waiting,20
1,32,953.1,535.6,1264,184,1448,2,waiting,20
1,33,960.4,538.4,1798,-51,1747,1,waiting,20
1,34,960.1,541.6,1525,-61,1464,1,waiting,20
1,35,962.2,544.6,2109,-278,1831,1,waiting,20
1,36,966.5,546.8,1448,-17,1431,1,waiting,20
1,37,961.2,544.9,2063,-282,1781,1,waiting,20
1,38,958.8,549.9,1888,-273,1615,1,waiting,20
1,39,952.7,554.9,1628,-48,1580,1,waiting,20
1,40,958.2,534.5,1800,-52,1748,1,waiting,20
2,1,979.7,551.8,506,-250,256,1,waiting,1
2,1,873.9,544.4,139,278,417,2,waiting,1
2,1,801.8,543.7,189,439,628,3,waiting,1
2,1,979.3,561.5,224,655,879,4,waiting,1
2,2,981.7,552.1,1611,-253,1358,1,waiting,1
2,2,1119.8,546.1,315,1384,1699,2,targOff,1
2,3,972.5,557.2,1634,-40,1594,1,waiting,1
2,3,791.8,546.6,191,1623,1814,2,targOff,1
2,4,965.6,565.2,1956,-36,1920,1,waiting,1
2,4,1145.9,557.2,230,1950,2180,2,targOff,1
2,5,967.6,554.7,1243,-76,1167,1,waiting,1
2,5,798.4,552.8,787,1211,1998,2,dotOff,1
2,6,967.8,554,1554,-261,1293,1,waiting,1
2,6,1158.9,550.2,738,1324,2062,2,dotOff,1
2,7,847.3,543.2,274,-267,7,1,waiting,1
2,7,972.4,554.8,1354,31,1385,2,waiting,1
2,7,1147.8,538.3,683,1415,2098,3,dotOff,1
2,8,967.5,554.2,1353,-262,1091,1,waiting,1
2,8,1147.8,547.4,470,1127,1597,2,targOff,1
2,9,968.5,556.7,1166,-248,918,1,waiting,1
2,9,959.1,557.8,521,927,1448,2,waiting,1
2,9,1128.4,553.2,588,1476,2064,3,dotOff,1
2,10,970.9,560,1597,-260,1337,1,waiting,1
2,10,755.5,575.2,227,1383,1610,2,targOff,1
2,11,1051.9,563.4,168,-160,8,1,waiting,1
2,11,975.2,567.2,1263,28,1291,2,waiting,1
2,11,791.8,563.1,522,1324,1846,3,targVis,1
2,12,979,560.3,1576,-259,1317,1,waiting,1
2,12,815.1,561.5,549,1348,1897,2,dotOff,1
2,13,1007.2,569.6,279,-258,21,1,waiting,1
2,13,969.2,564.3,494,38,532,2,waiting,1
2,13,960.3,567,835,539,1374,3,waiting,1
2,13,783.8,575.4,557,1423,1980,4,dotOff,1
2,14,969.8,559.8,1510,-260,1250,1,waiting,1
2,14,1160.1,557.1,536,1278,1814,2,targVis,1
2,15,973,558.8,1199,-9,1190,1,waiting,1
2,15,799.7,571.1,389,1226,1615,2,dotOff,1
2,15,773.1,561.4,129,1647,1776,3,targOff,1
2,16,964.4,561.6,1216,-248,968,1,waiting,1
2,16,807.7,567.7,504,1010,1514,2,targOff,1
2,17,968.5,559.4,1444,-261,1183,1,waiting,1
2,17,796.4,568.1,454,1226,1680,2,targOff,1
2,18,960.5,566.1,1527,-259,1268,1,waiting,1
2,18,811,564.1,510,1301,1811,2,targOff,1
2,19,946.5,548.3,282,-259,23,1,waiting,1
2,19,969.4,560.3,1395,32,1427,2,waiting,1
2,19,801.3,558.1,473,1458,1931,3,targOff,1
2,20,964.9,559.4,1092,-50,1042,1,waiting,1
2,20,804.6,574.1,423,1073,1496,2,targOff,1
2,21,962.2,559.4,1241,-252,989,1,waiting,1
2,21,801.9,563.7,495,1035,1530,2,targOff,1
2,22,964.7,557.5,1686,-252,1434,1,waiting,1
2,22,1143.3,556.6,502,1462,1964,2,targOff,1
2,23,971.5,557.6,755,-250,505,1,waiting,1
2,23,970.3,561.4,694,522,1216,2,waiting,1
2,23,818.3,568.2,345,1259,1604,3,targOff,1
2,23,790.5,551.9,138,1626,1764,4,targOff,1
2,24,972.8,561.4,1089,-245,844,1,waiting,1
2,24,966,565.1,313,863,1176,2,waiting,1
2,24,1116.7,554.2,377,1204,1581,3,targOff,1
2,25,969.5,561.1,1003,-32,971,1,waiting,1
2,25,797,564.4,491,1006,1497,2,targOff,1
2,26,973.4,562.5,1479,-260,1219,1,waiting,1
2,26,1132.1,568,484,1246,1730,2,targOff,1
2,27,976.2,564.1,1347,-259,1088,1,waiting,1
2,27,790.9,579.9,477,1137,1614,2,targOff,1
2,28,961.2,557.3,327,-106,221,1,waiting,1
2,28,965.9,563.1,855,326,1181,2,waiting,1
2,29,994.2,548.1,261,-221,40,1,waiting,1
2,29,972,558.2,1383,57,1440,2,waiting,1
2,29,782,562.9,458,1490,1948,3,targOff,1
2,30,961.1,561.8,1412,-261,1151,1,waiting,1
2,30,1130.2,554.7,422,1175,1597,2,targOff,1
2,31,966.5,565.5,1263,-251,1012,1,waiting,1
2,31,790.3,569.7,443,1055,1498,2,targOff,1
2,32,966,561.7,1468,-251,1217,1,waiting,1
2,32,788.8,564.9,462,1252,1714,2,targOff,1
2,33,963.8,560.6,1215,-252,963,1,waiting,1
2,33,1149,561,468,996,1464,2,targOff,1
2,34,969.8,561.9,1623,-195,1428,1,waiting,1
2,34,811.3,565,452,1479,1931,2,targOff,1
2,35,1000.6,549.8,159,-131,28,1,waiting,1
2,35,973.7,555.3,1303,47,1350,2,waiting,1
2,35,1145.1,558.1,453,1378,1831,3,targOff,1
2,36,961.3,557,1657,-253,1404,1,waiting,1
2,36,1110.6,550.5,374,1440,1814,2,targOff,1
2,37,977.3,564.9,571,-54,517,1,waiting,1
2,37,963.2,550.4,582,534,1116,2,waiting,1
2,37,1137.1,544.7,407,1140,1547,3,targOff,1
2,38,959.8,561,1113,-100,1013,1,waiting,1
2,38,804.5,561.7,470,1060,1530,2,targOff,1
2,39,970.1,557.7,1390,-268,1122,1,waiting,1
2,39,796,556,399,1165,1564,2,targOff,1
2,40,971.1,556.9,1310,-250,1060,1,waiting,1
2,40,1143.9,547.1,440,1089,1529,2,targOff,1
2,1,895.1,550.6,204,18,222,1,waiting,2
2,1,952.3,570.8,1461,236,1697,2,waiting,2
2,2,943.9,569.5,1806,-259,1547,1,waiting,2
2,3,937.4,565.4,2054,-259,1795,1,waiting,2
2,4,939.1,569,1722,-260,1462,1,waiting,2
2,5,950,562.5,2189,-259,1930,1,waiting,2
2,6,953.2,557,1753,-259,1494,1,waiting,2
2,7,944.7,561.7,1911,-264,1647,1,waiting,2
2,8,937.6,552.8,1042,-258,784,1,waiting,2
2,8,935,555.7,971,791,1762,2,waiting,2
2,9,942.4,564.4,1964,-250,1714,1,waiting,2
2,10,937.6,566.6,1853,-264,1589,1,waiting,2
2,11,939.3,568.9,2040,-259,1781,1,waiting,2
2,12,944.7,571.8,2006,-258,1748,1,waiting,2
2,13,945.3,563.7,2135,-255,1880,1,waiting,2
2,14,941.1,566.2,1821,-261,1560,1,waiting,2
2,15,943.8,560.3,2015,-267,1748,1,waiting,2
2,16,938.6,568.9,1726,-29,1697,1,waiting,2
2,17,936,572.5,1866,-252,1614,1,waiting,2
2,18,934.3,573.6,1926,-262,1664,1,waiting,2
2,19,943.5,567.9,2037,-260,1777,1,waiting,2
2,20,938.8,568.6,1980,-266,1714,1,waiting,2
2,21,942.5,564.8,2108,-261,1847,1,waiting,2
2,22,939.7,565.9,1809,-262,1547,1,waiting,2
2,23,937,566.1,1978,-247,1731,1,waiting,2
2,24,942.7,574.6,2107,-259,1848,1,waiting,2
2,25,944.7,561.9,1795,-248,1547,1,waiting,2
2,26,948.4,561.1,1790,-260,1530,1,waiting,2
2,27,944.5,562,2023,-259,1764,1,waiting,2
2,28,947,570.9,1893,-246,1647,1,waiting,2
2,29,940.8,568.1,2038,-259,1779,1,waiting,2
2,30,945.3,571.4,1989,-259,1730,1,waiting,2
2,31,933.7,572,785,-258,527,1,waiting,2
2,31,931.9,568.2,303,643,946,2,waiting,2
2,32,970.4,562,279,-252,27,1,waiting,2
2,32,946.3,561.4,1495,36,1531,2,waiting,2
2,33,939.5,565.5,1656,-79,1577,1,waiting,2
2,34,930.5,557.5,530,-259,271,1,waiting,2
2,34,974,561.2,130,282,412,2,waiting,2
2,34,941.1,563.5,1179,431,1610,3,waiting,2
2,35,937.4,569.5,1950,-253,1697,1,waiting,2
2,36,943.2,566.3,2157,-260,1897,1,waiting,2
2,37,940.5,567.6,2037,-259,1778,1,waiting,2
2,38,929.6,573.5,549,-158,391,1,waiting,2
2,38,936.3,586,527,501,1028,2,waiting,2
2,39,943.9,571.5,1919,12,1931,1,waiting,2
2,40,941.1,560.2,1712,-248,1464,1,waiting,2
2,1,936.2,564.7,1620,-254,1366,1,waiting,3
2,1,1104.9,567.1,463,1402,1865,2,targOff,3
2,2,972.6,566.4,264,-260,4,1,waiting,3
2,2,943.8,559.4,1057,22,1079,2,waiting,3
2,2,1116,556.7,407,1107,1514,3,targOff,3
2,3,943.5,561.4,1276,-26,1250,1,waiting,3
2,3,1132.3,567.9,538,1277,1815,2,targVis,3
2,4,938.6,555.4,1379,-260,1119,1,waiting,3
2,4,1113.9,550.8,292,1154,1446,2,targOff,3
2,5,942.3,559.8,1490,-253,1237,1,waiting,3
2,5,766.8,576,496,1284,1780,2,targOff,3
2,6,942.3,551,1400,-259,1141,1,waiting,3
2,6,762.4,570.4,440,1187,1627,2,targOff,3
2,7,940.1,554,1235,-260,975,1,waiting,3
2,7,760.7,566.9,441,1006,1447,2,targOff,3
2,8,936.3,560.6,1322,-257,1065,1,waiting,3
2,8,1118.5,556.2,471,1093,1564,2,targOff,3
2,9,935.6,559.5,1488,-252,1236,1,waiting,3
2,9,1113.4,574.2,498,1266,1764,2,targOff,3
2,10,939.3,553.9,1442,0,1442,1,waiting,3
2,10,777.6,573.7,440,1491,1931,2,targOff,3
2,11,935.7,559.1,732,-252,480,1,waiting,3
2,11,942.7,551.8,641,498,1139,2,waiting,3
2,11,1133.7,552.6,446,1168,1614,3,targOff,3
2,12,940,548.1,1279,-252,1027,1,waiting,3
2,12,1125.4,559.2,477,1054,1531,2,targOff,3
2,13,943.7,557.9,1237,-261,976,1,waiting,3
2,13,924.5,562.5,356,996,1352,2,waiting,3
2,13,1113.5,565.6,454,1393,1847,3,targOff,3
2,14,943.3,553.9,1271,-248,1023,1,waiting,3
2,14,773.6,566.4,427,1071,1498,2,targOff,3
2,15,970.8,544.4,287,-266,21,1,waiting,3
2,15,945.5,557.9,1380,27,1407,2,waiting,3
2,15,1134.7,555,447,1450,1897,3,targOff,3
2,16,933.7,559.2,1227,-263,964,1,waiting,3
2,16,1113.7,565.2,456,991,1447,2,targOff,3
2,17,947.6,560,1413,-267,1146,1,waiting,3
2,17,1123.5,553.7,442,1172,1614,2,targOff,3
2,18,946.7,558.4,1368,-267,1101,1,waiting,3
2,18,1121.4,560.7,487,1127,1614,2,targOff,3
2,19,942.6,556.8,1581,-265,1316,1,waiting,3
2,19,767.4,573.6,434,1364,1798,2,targOff,3
2,20,948.3,552.9,1357,-250,1107,1,waiting,3
2,20,1126.3,561.4,466,1131,1597,2,targOff,3
2,21,943.2,553.5,1634,-253,1381,1,waiting,3
2,21,790.3,576,453,1427,1880,2,targOff,3
2,22,949.3,557.2,1411,-4,1407,1,waiting,3
2,22,1123.2,560.1,429,1435,1864,2,targOff,3
2,23,936.9,558.3,314,-60,254,1,waiting,3
2,23,943.8,555.2,914,271,1185,2,waiting,3
2,23,1143.4,547.8,237,1227,1464,3,targOff,3
2,24,948.1,540.6,279,-250,29,1,waiting,3
2,24,941.2,560.8,1246,45,1291,2,waiting,3
2,24,1128.9,569.5,445,1319,1764,3,targOff,3
2,25,933,575.4,1349,-248,1101,1,waiting,3
2,25,1104.2,574.6,787,1127,1914,2,waiting,3
2,26,953.6,562.5,214,14,228,1,waiting,3
2,26,939.8,564.4,792,237,1029,2,waiting,3
2,26,773.4,581.3,423,1074,1497,3,targOff,3
2,27,943.7,574.3,575,-261,314,1,waiting,3
2,27,778.6,570.1,431,339,770,2,waiting,3
2,28,945,567.3,1404,4,1408,1,waiting,3
2,28,765.7,579.8,426,1454,1880,2,targOff,3
2,29,954.5,555.1,1486,-247,1239,1,waiting,3
2,29,943.7,569.5,121,1255,1376,2,dotOff,3
2,29,1124.7,566.4,427,1403,1830,3,targOff,3
2,30,940.8,562.5,1244,-260,984,1,waiting,3
2,30,1127,563.3,435,1011,1446,2,targOff,3
2,31,937.3,582.7,1397,-266,1131,1,waiting,3
2,32,951,565.4,305,-253,52,1,waiting,3
2,32,944.3,567.1,1315,69,1384,2,waiting,3
2,32,766.1,574.1,466,1415,1881,3,targOff,3
2,33,939.5,569.1,1410,-259,1151,1,waiting,3
2,33,764.5,572.5,434,1197,1631,2,targOff,3
2,34,939.7,571.3,1508,-259,1249,1,waiting,3
2,34,784.5,580.7,329,1281,1610,2,targOff,3
2,34,758.8,571.7,88,1639,1727,3,targOff,3
2,35,938.3,573.7,994,14,1008,1,waiting,3
2,35,774.5,592.2,413,1051,1464,2,targOff,3
2,36,938.1,574.2,1675,-252,1423,1,waiting,3
2,36,774.8,579.3,460,1471,1931,2,targOff,3
2,37,941.6,570.9,1417,-246,1171,1,waiting,3
2,37,768.9,576.3,445,1203,1648,2,targOff,3
2,38,930.5,571.1,1670,-265,1405,1,waiting,3
2,38,766.9,570.2,445,1452,1897,2,targOff,3
2,39,940.1,564,1258,-266,992,1,waiting,3
2,39,1101.1,567.5,308,1017,1325,2,targOff,3
2,39,1122.2,561.3,104,1343,1447,3,targOff,3
2,40,937.8,564.8,1587,-260,1327,1,waiting,3
2,40,769.7,573,455,1375,1830,2,targOff,3
2,1,849.8,571.6,180,-117,63,1,waiting,4
2,1,933.5,566.5,165,89,254,2,waiting,4
2,1,965.1,562.3,122,271,393,3,waiting,4
2,1,945.6,560.5,703,402,1105,4,waiting,4
2,1,935.7,565.5,435,1112,1547,5,targOff,4
2,2,950.8,574.6,1581,-33,1548,1,waiting,4
2,2,757.6,567.7,216,1598,1814,2,targOff,4
2,3,976.8,562.2,282,-257,25,1,waiting,4
2,3,945.5,565.1,1784,47,1831,2,waiting,4
2,4,944.4,562.7,1848,-251,1597,1,waiting,4
2,5,946,549.3,1846,-98,1748,1,waiting,4
2,6,945.4,548,1949,-252,1697,1,waiting,4
2,7,938.9,549.3,1807,-260,1547,1,waiting,4
2,8,949.1,553.8,2038,-260,1778,1,waiting,4
2,9,936.5,568.4,2056,-259,1797,1,waiting,4
2,10,947.5,558,2172,-259,1913,1,waiting,4
2,11,951.4,564.3,2130,-266,1864,1,waiting,4
2,12,948.6,573.7,154,-147,7,1,waiting,4
2,12,942.1,571.5,1791,23,1814,2,waiting,4
2,13,939.4,568.8,1727,-259,1468,1,waiting,4
2,13,777.1,574.1,211,1515,1726,2,targOff,4
2,14,945.3,568.2,1387,19,1406,1,waiting,4
2,14,930.1,565.5,104,1427,1531,2,targOff,4
2,15,947.4,564.7,1908,-261,1647,1,waiting,4
2,16,939.3,575.2,2003,-139,1864,1,waiting,4
2,17,939.4,569.8,1727,-263,1464,1,waiting,4
2,18,940.3,576.4,508,-258,250,1,waiting,4
2,18,947.3,571.8,1038,269,1307,2,waiting,4
2,18,930,570.4,157,1324,1481,3,targOff,4
2,19,942.2,571.5,2042,-261,1781,1,waiting,4
2,20,943.9,575.4,1932,-252,1680,1,waiting,4
2,21,945.9,563.5,1944,-262,1682,1,waiting,4
2,21,928.1,571.7,189,1708,1897,2,targOff,4
2,22,948.1,564.9,1824,-260,1564,1,waiting,4
2,23,946.7,564.6,1908,-261,1647,1,waiting,4
2,24,932.3,570.3,1723,-260,1463,1,waiting,4
2,25,945.7,570.2,2140,-260,1880,1,waiting,4
2,26,942.5,573,1837,-260,1577,1,waiting,4
2,26,940.6,572.2,195,1585,1780,2,targOff,4
2,27,944.5,573.9,1704,-261,1443,1,waiting,4
2,28,936.2,573.1,1689,-260,1429,1,waiting,4
2,29,947.8,576.6,2048,-267,1781,1,waiting,4
2,30,947,571.4,1870,-263,1607,1,waiting,4
2,30,932.5,573.2,187,1627,1814,2,targOff,4
2,31,937.9,574.5,1943,-261,1682,1,waiting,4
2,31,916.3,565.8,213,1701,1914,2,targOff,4
2,32,939.5,565.3,1757,-260,1497,1,waiting,4
2,33,940.6,564,1925,-261,1664,1,waiting,4
2,34,942.4,569.4,1790,-260,1530,1,waiting,4
2,35,949.9,576,2119,-259,1860,1,waiting,4
2,36,932.8,581.2,1183,-253,930,1,waiting,4
2,37,950.5,570.2,1373,-6,1367,1,waiting,4
2,37,944.5,574.5,457,1386,1843,2,targOff,4
2,38,936.8,576.3,1932,-251,1681,1,waiting,4
2,39,944.8,578.6,2090,-260,1830,1,waiting,4
2,40,946.7,588.4,494,-266,228,1,waiting,4
2,40,941,575.1,1412,235,1647,2,waiting,4
2,1,971.8,542.3,123,-32,91,1,waiting,5
2,1,964.2,570,1072,119,1191,2,waiting,5
2,1,774.5,565.9,454,1226,1680,3,targOff,5
2,2,957.9,569.3,1689,-261,1428,1,waiting,5
2,2,775.4,574.3,458,1472,1930,2,targOff,5
2,3,959.5,561.9,1222,-46,1176,1,waiting,5
2,3,1134.1,566.3,440,1205,1645,2,targOff,5
2,4,960,569.2,1256,-37,1219,1,waiting,5
2,4,1134.2,574.8,417,1247,1664,2,targOff,5
2,5,955.5,563.5,1299,-251,1048,1,waiting,5
2,5,780.2,568.7,448,1083,1531,2,targOff,5
2,6,955.6,565,1610,-264,1346,1,waiting,5
2,6,1123.9,564.5,457,1373,1830,2,targOff,5
2,7,953.6,560.7,1445,-255,1190,1,waiting,5
2,7,1134.8,569.6,431,1216,1647,2,targOff,5
2,8,961,566.6,1649,-260,1389,1,waiting,5
2,8,787.2,577.7,460,1433,1893,2,targOff,5
2,9,959.3,563.1,1226,-264,962,1,waiting,5
2,9,1137.3,557.5,439,992,1431,2,targOff,5
2,10,960.3,569.9,1647,-260,1387,1,waiting,5
2,10,1136.8,565.3,448,1413,1861,2,targOff,5
2,11,954.9,570.6,1570,-260,1310,1,waiting,5
2,11,1129.5,561.6,458,1339,1797,2,targOff,5
2,12,954.9,575.6,1538,-260,1278,1,waiting,5
2,12,1136.7,565.6,455,1308,1763,2,targOff,5
2,13,956.3,571.9,1568,-259,1309,1,waiting,5
2,13,775.6,568.1,472,1357,1829,2,targOff,5
2,14,955.1,572.3,1309,-260,1049,1,waiting,5
2,14,783.2,570.5,131,1080,1211,2,targOff,5
2,14,758.5,568.8,68,1392,1460,3,targOff,5
2,15,950.3,574.9,1710,-259,1451,1,waiting,5
2,15,1106.1,579.8,277,1478,1755,2,targOff,5
2,15,1150.7,571.5,97,1779,1876,3,targOff,5
2,16,948.3,574.6,1446,-262,1184,1,waiting,5
2,16,1136.8,579.1,414,1217,1631,2,targOff,5
2,17,953.6,573.2,1638,-260,1378,1,waiting,5
2,17,1138.8,577.3,456,1403,1859,2,targOff,5
2,18,957.2,569.2,1607,-261,1346,1,waiting,5
2,18,770.8,577.6,440,1391,1831,2,targOff,5
2,19,949,578.8,1561,-249,1312,1,waiting,5
2,19,764.6,585.8,436,1345,1781,2,targOff,5
2,20,948.7,575.4,1427,-51,1376,1,waiting,5
2,20,1139.1,570.4,440,1408,1848,2,targOff,5
2,21,950.7,575.3,1676,-250,1426,1,waiting,5
2,21,1132,576.2,156,1454,1610,2,targOff,5
2,21,1152.2,560.8,102,1748,1850,3,targOff,5
2,22,952.6,573.3,1695,-255,1440,1,waiting,5
2,22,782.3,583.4,458,1473,1931,2,targOff,5
2,23,951.6,577.3,1495,-260,1235,1,waiting,5
2,23,781,582.3,412,1283,1695,2,targOff,5
2,24,947.1,577.7,1875,-260,1615,1,waiting,5
2,24,796.8,571.8,181,1665,1846,2,targOff,5
2,25,953.3,576.4,1451,-261,1190,1,waiting,5
2,25,1132,586.8,429,1217,1646,2,targOff,5
2,26,950.1,575,1630,-261,1369,1,waiting,5
2,26,785.7,582.4,461,1403,1864,2,targOff,5
2,27,954,566.9,1482,-252,1230,1,waiting,5
2,27,1119.1,573.7,408,1257,1665,2,targOff,5
2,28,956.9,574.5,1475,-262,1213,1,waiting,5
2,28,1125.3,572,412,1252,1664,2,targOff,5
2,29,954,573.1,1383,-264,1119,1,waiting,5
2,29,780.5,588.4,455,1159,1614,2,targOff,5
2,30,956.3,574,1249,-253,996,1,waiting,5
2,30,1132.7,566.1,458,1023,1481,2,targOff,5
2,31,952.4,577.1,1609,-267,1342,1,waiting,5
2,31,769.9,588.1,240,1373,1613,2,targOff,5
2,32,949.5,573,1433,-260,1173,1,waiting,5
2,32,784.6,600.9,472,1222,1694,2,targOff,5
2,33,948.5,571.6,1475,-254,1221,1,waiting,5
2,33,1119.1,574.9,418,1246,1664,2,targOff,5
2,34,954.3,578.8,1536,-249,1287,1,waiting,5
2,34,1123.5,573.8,468,1313,1781,2,targOff,5
2,35,964.6,567.3,671,-253,418,1,waiting,5
2,35,947.7,570.9,780,433,1213,2,waiting,5
2,35,785.1,583.4,478,1253,1731,3,targOff,5
2,36,952.2,576.4,1648,-260,1388,1,waiting,5
2,36,1117.1,569.6,463,1414,1877,2,targOff,5
2,37,952.8,578.6,1101,-37,1064,1,waiting,5
2,37,779.3,582.4,466,1099,1565,2,targOff,5
2,38,956.1,569.5,1250,-259,991,1,waiting,5
2,38,1127,578.3,424,1024,1448,2,targOff,5
2,39,956.7,579.7,1314,-260,1054,1,waiting,5
2,39,1109.2,572.8,432,1078,1510,2,targOff,5
2,40,954.9,569.4,350,-261,89,1,waiting,5
2,40,949.1,574.1,1164,105,1269,2,waiting,5
2,40,1130.6,580.3,447,1300,1747,3,targOff,5
2,1,1002.1,566.8,289,-253,36,1,waiting,6
2,1,951.4,566.7,1671,60,1731,2,waiting,6
2,2,950.4,573.8,2097,-261,1836,1,waiting,6
2,3,946.2,576.5,1868,-254,1614,1,waiting,6
2,4,949.7,574.4,1783,-19,1764,1,waiting,6
2,5,960.3,571.6,235,-23,212,1,waiting,6
2,5,956,568.2,1321,227,1548,2,waiting,6
2,6,953.7,572.6,1971,-260,1711,1,waiting,6
2,7,948.6,570.6,1560,-32,1528,1,waiting,6
2,8,948.4,577,2026,-262,1764,1,waiting,6
2,9,987.8,575.8,284,-260,24,1,waiting,6
2,9,954.4,573.9,1618,41,1659,2,waiting,6
2,9,768.1,585.8,203,1711,1914,3,targOff,6
2,10,1001.6,566.3,236,-229,7,1,waiting,6
2,10,946.5,571.4,1630,31,1661,2,waiting,6
2,10,937.3,575.4,232,1682,1914,3,targOff,6
2,11,950,572.3,1886,-256,1630,1,waiting,6
2,12,947.9,575.9,1868,-254,1614,1,waiting,6
2,13,948.1,581,1500,-252,1248,1,waiting,6
2,14,946.1,577.8,1760,21,1781,1,waiting,6
2,15,957.2,574.4,282,-259,23,1,waiting,6
2,15,955.2,572,1386,42,1428,2,waiting,6
2,16,960.6,575.2,1920,-260,1660,1,waiting,6
2,17,955.4,575,1956,-260,1696,1,waiting,6
2,18,952.2,579.4,1262,-248,1014,1,waiting,6
2,19,966.6,579.4,160,-53,107,1,waiting,6
2,19,957,568,706,126,832,2,waiting,6
2,19,956.4,587.2,798,850,1648,3,waiting,6
2,20,962.2,573.8,275,-257,18,1,waiting,6
2,20,959.1,571.7,1737,25,1762,2,waiting,6
2,21,949,570.8,2016,-252,1764,1,waiting,6
2,22,951.5,566,1959,-28,1931,1,waiting,6
2,23,956.6,569,1856,-258,1598,1,waiting,6
2,23,939.3,562.9,225,1619,1844,2,targOff,6
2,24,953.9,567.8,1619,-252,1367,1,waiting,6
2,24,944.7,564.9,113,1384,1497,2,targOff,6
2,25,956.9,573.8,1715,-34,1681,1,waiting,6
2,26,1002.9,573.3,123,-110,13,1,waiting,6
2,26,957.2,574.8,1528,37,1565,2,waiting,6
2,27,950.5,580.1,2029,-249,1780,1,waiting,6
2,28,960.9,579,1179,-249,930,1,waiting,6
2,29,1010.2,578.3,256,-253,3,1,waiting,6
2,29,954,572.4,1405,26,1431,2,waiting,6
2,30,954.7,571.6,1970,-248,1722,1,waiting,6
2,30,944.8,567.4,116,1731,1847,2,targOff,6
2,31,956.2,568.3,1881,-267,1614,1,waiting,6
2,32,966,582.3,55,-41,14,1,waiting,6
2,32,954.1,565.2,1464,33,1497,2,waiting,6
2,33,951.1,579,1543,-46,1497,1,waiting,6
2,34,962,566.4,1648,-200,1448,1,waiting,6
2,35,959,577.6,2039,-260,1779,1,waiting,6
2,36,949.2,573,1810,-13,1797,1,waiting,6
2,37,954.1,579.2,465,-77,388,1,waiting,6
2,37,950.3,570.8,1220,402,1622,2,waiting,6
2,37,963.7,561.9,119,1643,1762,3,targOff,6
2,38,953.8,567.7,1941,-260,1681,1,waiting,6
2,39,955.3,579.9,2062,-253,1809,1,waiting,6
2,39,971.2,573.5,87,1827,1914,2,targOff,6
2,40,956.5,563.5,1852,-259,1593,1,waiting,6
2,1,1107.2,581.1,286,-257,29,1,waiting,7
2,1,926.6,569.7,252,75,327,2,waiting,7
2,1,944.7,578.9,791,334,1125,3,waiting,7
2,1,774.2,580.3,423,1174,1597,4,targOff,7
2,2,941.4,574.3,1559,-260,1299,1,waiting,7
2,2,1132.5,569.8,454,1324,1778,2,targOff,7
2,3,939.6,573.3,1137,-22,1115,1,waiting,7
2,3,1110.2,580.3,406,1141,1547,2,targOff,7
2,4,975.4,583.2,264,-253,11,1,waiting,7
2,4,952.8,570.6,1082,21,1103,2,waiting,7
2,4,772,575.4,427,1137,1564,3,targOff,7
2,5,955.2,570,1298,-252,1046,1,waiting,7
2,5,1119.4,570.8,422,1075,1497,2,targOff,7
2,6,949.9,573.8,1482,-250,1232,1,waiting,7
2,6,773.8,582,468,1278,1746,2,targOff,7
2,7,951.7,575.9,1074,-12,1062,1,waiting,7
2,7,784.8,583.2,469,1096,1565,2,targOff,7
2,8,952.9,568.6,1107,-138,969,1,waiting,7
2,8,785.6,589.4,463,1001,1464,2,targOff,7
2,9,943.4,576.8,2036,-252,1784,1,waiting,7
2,9,792.2,576.1,82,1832,1914,2,targOff,7
2,10,957,579.1,1414,-266,1148,1,waiting,7
2,10,793.2,587.8,451,1180,1631,2,targOff,7
2,11,957.8,577.8,614,-261,353,1,waiting,7
2,11,958.4,574.9,1182,366,1548,2,waiting,7
2,11,765.5,586.1,337,1593,1930,3,targOff,7
2,12,949.6,576,1280,-251,1029,1,waiting,7
2,12,1119,585.3,426,1055,1481,2,targOff,7
2,13,954.5,585.4,1090,-43,1047,1,waiting,7
2,14,923,575.8,264,-259,5,1,waiting,7
2,14,949.7,572.9,1288,23,1311,2,waiting,7
2,14,805.8,581.3,337,1359,1696,3,targOff,7
2,14,748.6,590,81,1716,1797,4,targOff,7
2,15,974.8,566.8,280,-259,21,1,waiting,7
2,15,948.1,564.7,1235,38,1273,2,waiting,7
2,15,768.8,587,491,1321,1812,3,targOff,7
2,16,950.4,574.8,1536,-252,1284,1,waiting,7
2,16,794.5,583.1,352,1333,1685,2,targOff,7
2,16,760.3,582.7,88,1710,1798,3,targOff,7
2,17,949.2,578.7,998,16,1014,1,waiting,7
2,17,767.5,578,448,1063,1511,2,targOff,7
2,18,956.4,573.4,1483,-259,1224,1,waiting,7
2,18,784.1,595.4,662,1268,1930,2,dotOff,7
2,19,884.8,563.5,129,-110,19,1,waiting,7
2,19,949.8,575.3,1015,46,1061,2,waiting,7
2,19,770.2,586.4,422,1109,1531,3,targOff,7
2,20,953.9,580.6,1219,-259,960,1,waiting,7
2,21,986.5,562.9,269,-258,11,1,waiting,7
2,21,947.2,575.5,1149,35,1184,2,waiting,7
2,21,1121.6,559.3,305,1209,1514,3,targOff,7
2,22,951.8,571.4,1551,-261,1290,1,waiting,7
2,22,1114.5,568.9,479,1318,1797,2,targOff,7
2,23,955.6,578.9,1562,-260,1302,1,waiting,7
2,23,1127.6,579.7,451,1328,1779,2,targOff,7
2,24,956.8,565.8,1256,-24,1232,1,waiting,7
2,24,1116.3,581.1,421,1260,1681,2,targOff,7
2,25,955.6,567.8,1689,-250,1439,1,waiting,7
2,25,1112,571.6,466,1463,1929,2,targOff,7
2,26,955.7,568.1,1278,-258,1020,1,waiting,7
2,26,1129.1,574.3,449,1049,1498,2,targOff,7
2,27,955.2,576,1677,-264,1413,1,waiting,7
2,27,1111.4,572.2,472,1442,1914,2,targOff,7
2,28,953.7,560.3,1442,-47,1395,1,waiting,7
2,28,773,572.8,472,1441,1913,2,targOff,7
2,29,949.6,569.6,1364,-253,1111,1,waiting,7
2,29,1123.7,571.7,442,1138,1580,2,targOff,7
2,30,954.5,566.6,1419,-251,1168,1,waiting,7
2,30,1122,575.7,468,1194,1662,2,targOff,7
2,31,954.9,566.1,1452,-262,1190,1,waiting,7
2,31,1132.3,574.1,482,1216,1698,2,targOff,7
2,32,959.1,574.8,1496,-251,1245,1,waiting,7
2,32,1060.3,582.3,142,1267,1409,2,targOff,7
2,32,1141.5,572.3,164,1433,1597,3,targOff,7
2,33,962.2,580.7,362,-259,103,1,waiting,7
2,33,959.1,564.8,989,123,1112,2,waiting,7
2,33,947.6,574.2,274,1120,1394,3,waiting,7
2,33,1125.6,572.1,439,1424,1863,4,targOff,7
2,34,952.1,563.2,290,-252,38,1,waiting,7
2,34,957.7,567.1,1097,45,1142,2,waiting,7
2,34,778.2,590,452,1178,1630,3,targOff,7
2,35,958.1,562.9,1363,-252,1111,1,waiting,7
2,35,789.6,583.7,275,1158,1433,2,targOff,7
2,35,759.3,571.7,166,1448,1614,3,targOff,7
2,36,980.5,573.5,144,-95,49,1,waiting,7
2,36,957.7,566.5,1275,70,1345,2,waiting,7
2,36,775.2,596.8,468,1396,1864,3,targOff,7
2,37,952.5,582.1,560,-263,297,1,waiting,7
2,37,950.6,571.1,930,304,1234,2,waiting,7
2,37,776.9,580.6,464,1283,1747,3,targOff,7
2,38,944.5,573.2,1214,-30,1184,1,waiting,7
2,38,780.7,587.2,469,1228,1697,2,targOff,7
2,39,953.6,564,1486,-251,1235,1,waiting,7
2,39,1119.3,578,470,1261,1731,2,targOff,7
2,40,959.5,568.9,1537,-170,1367,1,waiting,7
2,40,772.2,588,493,1404,1897,2,targOff,7
2,1,976.2,561.1,254,-220,34,1,waiting,8
2,1,943.8,583.7,1442,55,1497,2,waiting,8
2,2,950.3,571.9,1284,-260,1024,1,waiting,8
2,2,939.7,562.5,650,1031,1681,2,dotOff,8
2,3,948.5,583.6,1119,-255,864,1,waiting,8
2,4,937.8,575.4,1697,-253,1444,1,waiting,8
2,4,952,569.1,116,1465,1581,2,targOff,8
2,5,948.7,574.2,1875,-247,1628,1,waiting,8
2,5,941.5,578.7,180,1650,1830,2,targOff,8
2,6,944.3,573.3,1786,-254,1532,1,waiting,8
2,7,942.7,580.4,1875,-261,1614,1,waiting,8
2,8,930.2,569.6,121,-111,10,1,waiting,8
2,8,947.4,566.8,699,98,797,2,waiting,8
2,9,977.5,575.3,183,-155,28,1,waiting,8
2,9,947.5,578.7,1401,46,1447,2,waiting,8
2,10,953.3,574.1,1779,18,1797,1,waiting,8
2,11,955.7,575.6,1776,-263,1513,1,waiting,8
2,11,952.2,573.1,231,1533,1764,2,targOff,8
2,12,961.2,570.5,1562,-259,1303,1,waiting,8
2,12,950.5,578.7,236,1312,1548,2,targOff,8
2,13,961.8,569.9,445,-42,403,1,waiting,8
2,13,953.8,577,841,417,1258,2,waiting,8
2,13,965.7,570.5,211,1270,1481,3,targOff,8
2,14,956.6,576,1938,-258,1680,1,waiting,8
2,15,947.6,569.4,1724,-260,1464,1,waiting,8
2,16,956,571.5,2007,-260,1747,1,waiting,8
2,17,953,576.2,2093,-246,1847,1,waiting,8
2,18,952.9,579.4,1968,-141,1827,1,waiting,8
2,19,954.7,570.7,1657,-26,1631,1,waiting,8
2,20,956.2,568.1,1706,-259,1447,1,waiting,8
2,21,950.9,577.7,1835,-254,1581,1,waiting,8
2,22,949.8,571.8,1699,-252,1447,1,waiting,8
2,23,951.9,583.7,1169,-255,914,1,waiting,8
2,24,866.5,574.5,165,-157,8,1,waiting,8
2,24,951.9,570.7,788,34,822,2,waiting,8
2,24,953.6,574.1,945,836,1781,3,waiting,8
2,25,962.6,578.5,363,-260,103,1,waiting,8
2,25,950.9,579.1,1518,110,1628,2,waiting,8
2,26,978.7,585.4,258,-258,0,1,waiting,8
2,26,954.6,578.2,1559,23,1582,2,waiting,8
2,26,964.6,574.8,131,1600,1731,3,targOff,8
2,27,954.5,568.5,1643,4,1647,1,waiting,8
2,28,954.5,573.9,1227,-264,963,1,waiting,8
2,28,943.6,563.9,146,983,1129,2,targOff,8
2,28,960.8,565.7,334,1146,1480,3,targOff,8
2,29,950,568.7,1873,-259,1614,1,waiting,8
2,30,954.4,575,1893,-262,1631,1,waiting,8
2,31,956.7,571,2133,-252,1881,1,waiting,8
2,32,955.9,579.2,1134,-253,881,1,waiting,8
2,33,947,567.1,2045,-132,1913,1,waiting,8
2,34,943.6,580.8,1230,-32,1198,1,waiting,8
2,35,951.4,569.6,1645,-1,1644,1,waiting,8
2,35,943,574.7,106,1658,1764,2,targOff,8
2,36,945.5,579.5,1074,-260,814,1,waiting,8
2,37,952.1,567.2,1766,-185,1581,1,waiting,8
2,38,955.3,574.3,1993,-263,1730,1,waiting,8
2,39,972,569.8,265,-261,4,1,waiting,8
2,39,955,572.5,1566,15,1581,2,waiting,8
2,40,947.1,573.7,1758,-261,1497,1,waiting,8
2,1,1148.8,534.8,126,-114,12,1,waiting,9
2,1,948.6,542.4,962,56,1018,2,waiting,9
2,1,776.6,543.3,400,1063,1463,3,targOff,9
2,2,946,544.5,1494,-251,1243,1,waiting,9
2,2,772.1,544.3,490,1291,1781,2,targOff,9
2,3,944.2,538.5,1407,-261,1146,1,waiting,9
2,3,1117.9,541.8,456,1175,1631,2,targOff,9
2,4,945.4,535.1,1356,-247,1109,1,waiting,9
2,4,766.8,544.1,458,1156,1614,2,targOff,9
2,5,941.3,538.3,1455,-266,1189,1,waiting,9
2,5,771.9,545.3,460,1237,1697,2,targOff,9
2,6,942.3,539.4,1518,-264,1254,1,waiting,9
2,6,785.3,546.7,447,1301,1748,2,targOff,9
2,7,945.7,540.8,1358,-260,1098,1,waiting,9
2,7,773.2,549.9,432,1145,1577,2,targOff,9
2,8,942.3,540.6,1678,-262,1416,1,waiting,9
2,8,1123.4,537,445,1442,1887,2,targOff,9
2,9,944.6,546.8,1814,-264,1550,1,waiting,9
2,9,1112.5,538.2,272,1575,1847,2,targOff,9
2,10,929.4,537.2,297,-267,30,1,waiting,9
2,10,943.6,547.9,1411,38,1449,2,waiting,9
2,10,1120.2,545.2,432,1477,1909,3,targOff,9
2,11,934.1,540.2,1625,-254,1371,1,waiting,9
2,11,785.5,550,447,1417,1864,2,targOff,9
2,12,940.3,544.9,1385,-255,1130,1,waiting,9
2,12,1123.3,537.2,440,1157,1597,2,targOff,9
2,13,937.4,547.2,1670,-248,1422,1,waiting,9
2,13,776.2,551.6,277,1451,1728,2,targOff,9
2,13,746.3,550.2,167,1747,1914,3,targOff,9
2,14,912.9,546.3,284,-262,22,1,waiting,9
2,14,943.5,538.6,1340,41,1381,2,waiting,9
2,14,1117.5,541.1,439,1408,1847,3,targOff,9
2,15,940.4,554.2,1564,-260,1304,1,waiting,9
2,15,769.9,566.1,445,1352,1797,2,targOff,9
2,16,941,547.3,1565,-263,1302,1,waiting,9
2,16,777.1,557.1,424,1357,1781,2,targOff,9
2,17,936.3,552.7,1624,-199,1425,1,waiting,9
2,17,766.9,550.5,426,1455,1881,2,targOff,9
2,18,938.8,554.1,162,-92,70,1,waiting,9
2,18,938.3,550.7,1038,88,1126,2,waiting,9
2,18,1111.5,549.8,427,1152,1579,3,targOff,9
2,19,936.5,541.6,1293,17,1310,1,waiting,9
2,19,1113.2,555.1,444,1337,1781,2,targOff,9
2,20,944.7,547.3,1271,-259,1012,1,waiting,9
2,20,775,556.1,437,1059,1496,2,targOff,9
2,21,944.2,542.7,420,-50,370,1,waiting,9
2,21,938.3,551.5,1049,387,1436,2,waiting,9
2,21,1119.9,543.9,449,1465,1914,3,targOff,9
2,22,942.3,552.1,1372,-254,1118,1,waiting,9
2,22,769.5,559.9,366,1164,1530,2,targOff,9
2,23,942.7,548.4,1646,-255,1391,1,waiting,9
2,23,1135.2,541.1,462,1418,1880,2,targOff,9
2,24,938.4,537.5,1164,-35,1129,1,waiting,9
2,24,1129.9,540.3,440,1158,1598,2,targOff,9
2,25,939.2,544.1,1430,-192,1238,1,waiting,9
2,25,761.5,557.7,422,1294,1716,2,targOff,9
2,26,938.8,539.6,1605,-249,1356,1,waiting,9
2,26,769.1,548.6,464,1384,1848,2,targOff,9
2,27,942.6,550.8,1462,-263,1199,1,waiting,9
2,27,766.9,551.8,451,1247,1698,2,targOff,9
2,28,934.5,543.4,1537,-260,1277,1,waiting,9
2,28,781.9,555.9,466,1313,1779,2,targOff,9
2,29,941.9,544.2,1278,-260,1018,1,waiting,9
2,29,775.1,548.4,444,1054,1498,2,targOff,9
2,30,945.1,542.5,1512,-262,1250,1,waiting,9
2,30,1117.7,537.5,437,1277,1714,2,targOff,9
2,31,941.1,546.2,1372,-259,1113,1,waiting,9
2,31,1104.1,533.9,406,1138,1544,2,targOff,9
2,32,901.5,545.3,169,-148,21,1,waiting,9
2,32,943,538.4,1189,36,1225,2,waiting,9
2,32,1110.2,539.2,411,1251,1662,3,targOff,9
2,33,979.7,543.6,136,-111,25,1,waiting,9
2,33,942,540.9,1085,44,1129,2,waiting,9
2,33,762.7,549.8,427,1171,1598,3,targOff,9
2,34,934.2,550.4,1316,-261,1055,1,waiting,9
2,34,789.9,550.1,449,1099,1548,2,targOff,9
2,35,940.5,547.7,1530,-262,1268,1,waiting,9
2,35,1124.6,533.1,464,1299,1763,2,targOff,9
2,36,939.2,546.5,1226,-34,1192,1,waiting,9
2,36,776.1,552.7,437,1227,1664,2,targOff,9
2,37,940.9,546.1,1363,-192,1171,1,waiting,9
2,37,783.4,545.7,438,1226,1664,2,targOff,9
2,38,940.9,540.8,1680,-261,1419,1,waiting,9
2,38,1119,543.6,452,1446,1898,2,targOff,9
2,39,938.5,549.3,1472,-267,1205,1,waiting,9
2,39,784,561.8,445,1252,1697,2,targOff,9
2,40,944,547.4,1572,-269,1303,1,waiting,9
2,40,778.1,558.7,288,1351,1639,2,targOff,9
2,40,741,542.8,123,1657,1780,3,targOff,9
2,1,932.8,541.3,1820,11,1831,1,waiting,10
2,2,944.6,542.7,1877,-263,1614,1,waiting,10
2,3,936.2,543,1820,-108,1712,1,waiting,10
2,4,940.7,541.1,1777,-80,1697,1,waiting,10
2,5,944,542.9,1532,-260,1272,1,waiting,10
2,5,934.4,548.8,188,1289,1477,2,targOff,10
2,6,934.7,543.6,1962,-265,1697,1,waiting,10
2,7,940.7,547.1,1910,-262,1648,1,waiting,10
2,8,948.1,539.7,2066,-252,1814,1,waiting,10
2,9,945.8,534.4,1695,-265,1430,1,waiting,10
2,10,945.2,547.8,1931,-250,1681,1,waiting,10
2,11,947.5,542.2,1886,-256,1630,1,waiting,10
2,12,939.3,548.3,2135,-254,1881,1,waiting,10
2,13,957.9,558.3,299,-263,36,1,waiting,10
2,13,948.3,545.8,1502,45,1547,2,waiting,10
2,13,942.1,540.4,198,1566,1764,3,targOff,10
2,14,945.9,544.3,1950,-253,1697,1,waiting,10
2,15,951.8,542.8,265,-260,5,1,waiting,10
2,15,942.9,540.5,1699,12,1711,2,waiting,10
2,16,931.5,551,1901,-254,1647,1,waiting,10
2,17,960.3,550.9,380,-260,120,1,waiting,10
2,17,935,559.1,1664,132,1796,2,waiting,10
2,18,938.4,548.9,1004,-253,751,1,waiting,10
2,18,939,549.1,1019,761,1780,2,waiting,10
2,19,937,546.7,870,-251,619,1,waiting,10
2,19,935.8,545.4,1059,638,1697,2,waiting,10
2,20,939.9,551.9,1884,-259,1625,1,waiting,10
2,20,923.4,547.9,245,1648,1893,2,targOff,10
2,21,936.7,549.6,2089,-258,1831,1,waiting,10
2,22,943.5,543.3,1815,-252,1563,1,waiting,10
2,23,945.8,541.8,1902,-254,1648,1,waiting,10
2,24,945.4,542.9,1731,-34,1697,1,waiting,10
2,25,941.5,548.4,2012,-249,1763,1,waiting,10
2,26,942.3,546.6,2021,-260,1761,1,waiting,10
2,27,946,546.7,1800,-253,1547,1,waiting,10
2,28,934.9,550.7,1914,-251,1663,1,waiting,10
2,28,931.5,547.2,142,1672,1814,2,targOff,10
2,29,940.6,544.1,1687,-256,1431,1,waiting,10
2,29,934.9,542.9,213,1451,1664,2,targOff,10
2,30,940.2,547.8,2119,-255,1864,1,waiting,10
2,31,939.4,542,1857,-260,1597,1,waiting,10
2,32,934.3,548.3,1937,-260,1677,1,waiting,10
2,33,939,546.9,1746,-249,1497,1,waiting,10
2,34,940.3,548.7,2115,-268,1847,1,waiting,10
2,35,943.5,542.1,1688,-260,1428,1,waiting,10
2,36,936,547.1,1838,-258,1580,1,waiting,10
2,37,939.1,551.9,1691,-260,1431,1,waiting,10
2,38,930.1,521.7,264,-254,10,1,waiting,10
2,38,934.8,546.5,284,20,304,2,waiting,10
2,38,937.6,547.2,1569,311,1880,3,waiting,10
2,39,947,538.4,1887,-23,1864,1,waiting,10
2,40,945.4,548.6,1705,-258,1447,1,waiting,10
2,1,933.5,583.4,644,554,1198,1,waiting,11
2,2,901.2,545.7,140,-109,31,1,waiting,11
2,2,937.1,536,1233,43,1276,2,waiting,11
2,2,1118.8,536.4,407,1324,1731,3,targOff,11
2,3,939.1,540.6,1882,-262,1620,1,waiting,11
2,3,1118.8,536.1,282,1649,1931,2,targOff,11
2,4,936.2,541.7,1360,-251,1109,1,waiting,11
2,4,762,542.1,564,1167,1731,2,dotOff,11
2,5,942.1,535.7,1562,-260,1302,1,waiting,11
2,5,1125.3,541.3,477,1336,1813,2,targOff,11
2,6,932.4,533.4,1472,-31,1441,1,waiting,11
2,6,776.2,549.5,461,1466,1927,2,targOff,11
2,7,938.3,535,1392,-253,1139,1,waiting,11
2,7,1131.8,540.7,434,1164,1598,2,targOff,11
2,8,933.6,549.9,1142,-34,1108,1,waiting,11
2,8,777.2,552.5,458,1156,1614,2,targOff,11
2,9,934.8,547.6,1418,-253,1165,1,waiting,11
2,9,768.8,543.4,246,1218,1464,2,targOff,11
2,10,931.9,548.5,1473,-258,1215,1,waiting,11
2,10,1112.5,534.5,302,1245,1547,2,targOff,11
2,11,974.3,545.5,247,-208,39,1,waiting,11
2,11,934,547.5,1120,60,1180,2,waiting,11
2,11,780.2,554.7,454,1227,1681,3,targOff,11
2,12,955.1,551,132,-130,2,1,waiting,11
2,12,940.3,548.4,423,20,443,2,waiting,11
2,12,936.7,544.9,729,461,1190,3,waiting,11
2,12,1129.8,539.6,477,1216,1693,4,targOff,11
2,13,931,541.4,1275,-259,1016,1,waiting,11
2,13,1108.5,543.2,407,1039,1446,2,targOff,11
2,14,942.5,538.1,1407,-219,1188,1,waiting,11
2,14,1107.9,543.8,404,1226,1630,2,targOff,11
2,15,979.9,533.9,274,-258,16,1,waiting,11
2,15,944.3,538.2,144,36,180,2,waiting,11
2,15,932.1,534.2,256,195,451,3,waiting,11
2,15,939.8,546.3,933,467,1400,4,waiting,11
2,15,761,551.1,479,1435,1914,5,targOff,11
2,16,932,544,1579,-254,1325,1,waiting,11
2,16,778.9,562,478,1353,1831,2,targOff,11
2,17,945.1,544.7,1269,-260,1009,1,waiting,11
2,17,772.7,557.8,438,1055,1493,2,targOff,11
2,18,941.5,547.7,1685,-261,1424,1,waiting,11
2,18,779.2,550.9,434,1461,1895,2,targOff,11
2,19,938.1,545.5,1305,-262,1043,1,waiting,11
2,19,1127.4,542.3,460,1070,1530,2,targOff,11
2,20,938,547.9,1302,-260,1042,1,waiting,11
2,20,768.4,560.2,449,1078,1527,2,targOff,11
2,21,941.3,539.4,1519,-260,1259,1,waiting,11
2,21,1118,553.3,441,1285,1726,2,targOff,11
2,22,949.1,547.4,1505,-259,1246,1,waiting,11
2,22,1126.7,534.8,473,1272,1745,2,targOff,11
2,23,944.4,552.1,1414,-261,1153,1,waiting,11
2,23,785.3,556,457,1190,1647,2,targOff,11
2,24,946.3,552.2,1302,-254,1048,1,waiting,11
2,24,1115.8,551.8,425,1072,1497,2,targOff,11
2,25,960,547.2,376,-260,116,1,waiting,11
2,25,935.5,559.7,125,135,260,2,waiting,11
2,25,947.3,559.4,941,268,1209,3,waiting,11
2,25,1118.8,542.1,391,1236,1627,4,targOff,11
2,26,943.9,549.3,1190,-254,936,1,waiting,11
2,26,777.4,547.3,462,968,1430,2,targOff,11
2,27,942.8,543.3,1180,-135,1045,1,waiting,11
2,27,1118,535.8,442,1069,1511,2,targOff,11
2,28,940,550.4,1192,-32,1160,1,waiting,11
2,28,1126.6,540.8,457,1187,1644,2,targOff,11
2,29,939.1,540.8,1274,-187,1087,1,waiting,11
2,29,788.6,550.2,451,1130,1581,2,targOff,11
2,30,942.3,544.9,1548,-260,1288,1,waiting,11
2,30,1120.6,534.4,450,1313,1763,2,targOff,11
2,31,938.2,550.2,1231,-260,971,1,waiting,11
2,31,1111.8,546,417,997,1414,2,targOff,11
2,32,986.1,542.1,142,-134,8,1,waiting,11
2,32,939.3,555.9,1260,32,1292,2,waiting,11
2,32,1116.4,541.2,478,1319,1797,3,targOff,11
2,33,934.2,545,619,-251,368,1,waiting,11
2,33,938.8,549.6,65,384,449,2,waiting,11
2,33,921.4,541.6,84,467,551,3,waiting,11
2,33,935.3,537.2,738,567,1305,4,waiting,11
2,33,767.7,551.1,411,1353,1764,5,targOff,11
2,34,939.6,538.4,1262,-250,1012,1,waiting,11
2,34,911.1,535,120,1026,1146,2,targVis,11
2,34,786.6,546.7,359,1188,1547,3,targOff,11
2,35,947,545.1,447,-249,198,1,waiting,11
2,35,948.6,546,1042,211,1253,2,waiting,11
2,35,1131.2,534.2,429,1284,1713,3,targOff,11
2,36,936.4,537.8,337,-260,77,1,waiting,11
2,36,945.1,548.5,977,94,1071,2,waiting,11
2,36,780.2,545.8,319,1103,1422,3,targOff,11
2,36,752.5,547.5,108,1451,1559,4,targOff,11
2,37,940.8,546.1,1685,-259,1426,1,waiting,11
2,37,1121.1,543.8,427,1453,1880,2,targOff,11
2,38,936.5,545.7,1490,-260,1230,1,waiting,11
2,38,1109.4,537.2,453,1256,1709,2,targOff,11
2,39,974.3,538.8,156,-128,28,1,waiting,11
2,39,937.3,545.6,1142,50,1192,2,waiting,11
2,39,1108.7,543.7,443,1218,1661,3,targOff,11
2,40,942.3,534.8,1314,-2,1312,1,waiting,11
2,40,1116.1,536.2,457,1340,1797,2,targOff,11
2,1,1015.1,530.6,280,-253,27,1,waiting,12
2,1,977.9,539.9,1556,41,1597,2,waiting,12
2,2,966.5,538.5,1790,-260,1530,1,waiting,12
2,3,966.6,541.5,1728,-68,1660,1,waiting,12
2,4,968.2,537.4,1669,-255,1414,1,waiting,12
2,5,967.9,538.2,1854,-260,1594,1,waiting,12
2,6,960.4,541.8,2068,-254,1814,1,waiting,12
2,7,964.7,537.5,2027,-263,1764,1,waiting,12
2,8,960.4,538.6,1851,-254,1597,1,waiting,12
2,9,965.3,537.1,1966,-252,1714,1,waiting,12
2,10,960.6,537.4,1549,-6,1543,1,waiting,12
2,11,955.6,544.3,1718,-254,1464,1,waiting,12
2,12,950.6,544.4,1795,-247,1548,1,waiting,12
2,13,967.5,542.8,1932,-55,1877,1,waiting,12
2,14,957.4,549.8,1673,-260,1413,1,waiting,12
2,15,958.6,540.6,1874,-260,1614,1,waiting,12
2,16,956.4,541.5,2080,-266,1814,1,waiting,12
2,17,957.7,550.7,1625,-161,1464,1,waiting,12
2,18,955.6,539.9,1754,-260,1494,1,waiting,12
2,19,957.3,546.1,1766,-251,1515,1,waiting,12
2,20,952.2,545.5,2055,-257,1798,1,waiting,12
2,21,948.4,548.3,1971,-260,1711,1,waiting,12
2,22,959.2,544.3,1700,-252,1448,1,waiting,12
2,23,956.7,544.8,2117,-253,1864,1,waiting,12
2,24,958.3,547.7,2025,-178,1847,1,waiting,12
2,25,956.7,539.6,1934,-253,1681,1,waiting,12
2,26,953.6,554.3,1641,7,1648,1,waiting,12
2,27,956.8,543.4,1732,-251,1481,1,waiting,12
2,28,955.8,544.3,1581,-134,1447,1,waiting,12
2,29,952.3,548.8,1666,-18,1648,1,waiting,12
2,30,955,548.3,1938,-259,1679,1,waiting,12
2,31,955.9,550.8,2124,-260,1864,1,waiting,12
2,32,963.4,547,215,-33,182,1,waiting,12
2,32,960.3,542.8,1265,199,1464,2,waiting,12
2,33,946.1,550,1907,-260,1647,1,waiting,12
2,34,953.1,549.8,1984,-254,1730,1,waiting,12
2,35,948.7,551.7,1665,-251,1414,1,waiting,12
2,36,956.8,549,2148,-251,1897,1,waiting,12
2,37,954.7,548.8,2017,-253,1764,1,waiting,12
2,38,961.1,543.1,365,-252,113,1,waiting,12
2,38,951.2,548.7,1702,129,1831,2,waiting,12
2,39,961.4,544.3,1603,-123,1480,1,waiting,12
2,40,950.7,544.7,1722,-259,1463,1,waiting,12
2,1,1020.7,547.8,258,-257,1,1,waiting,13
2,1,954.5,547.6,1390,26,1416,2,waiting,13
2,1,1122.4,541.1,439,1442,1881,3,targOff,13
2,2,955.4,541.4,1259,-255,1004,1,waiting,13
2,2,785.1,547.7,394,1037,1431,2,targOff,13
2,3,954.3,552,280,-255,25,1,waiting,13
2,3,952.7,555.2,1139,41,1180,2,waiting,13
2,3,1129.4,550,491,1206,1697,3,targOff,13
2,4,957.4,549.2,1074,-35,1039,1,waiting,13
2,4,1131.6,541.7,394,1070,1464,2,targOff,13
2,5,957.1,550.2,981,-38,943,1,waiting,13
2,5,1104.4,539.6,515,983,1498,2,dotOff,13
2,5,1151.3,548.5,123,1521,1644,3,targOff,13
2,6,960.8,547,1428,-260,1168,1,waiting,13
2,6,1139.5,546.5,446,1197,1643,2,targOff,13
2,7,958.3,547.5,1397,-51,1346,1,waiting,13
2,7,763.8,546.5,416,1394,1810,2,targOff,13
2,8,935.2,545.3,289,-259,30,1,waiting,13
2,8,958.3,544.3,1304,48,1352,2,waiting,13
2,8,783.7,537.4,431,1400,1831,3,targOff,13
2,9,946,529.6,162,-160,2,1,waiting,13
2,9,953.9,554,1374,18,1392,2,waiting,13
2,9,1127.7,549.9,431,1416,1847,3,targOff,13
2,10,960.5,542.4,1722,-260,1462,1,waiting,13
2,10,1137.2,547.4,437,1489,1926,2,targOff,13
2,11,951.9,550.7,1987,-259,1728,1,waiting,13
2,12,963.2,531.6,687,3,690,1,waiting,13
2,12,961.1,537.9,298,697,995,2,waiting,13
2,12,770.7,543.1,407,1039,1446,3,targOff,13
2,13,961.6,542.1,1490,-259,1231,1,waiting,13
2,13,1135,548.4,480,1264,1744,2,targOff,13
2,14,947.8,544.5,1345,-36,1309,1,waiting,13
2,14,1119.1,544.5,445,1333,1778,2,targOff,13
2,15,957.6,543.5,1538,-246,1292,1,waiting,13
2,15,777.6,526.2,456,1325,1781,2,targOff,13
2,16,949.3,551.1,1614,-253,1361,1,waiting,13
2,16,778.3,545,459,1405,1864,2,targOff,13
2,17,959.3,542.1,1428,-251,1177,1,waiting,13
2,17,1128.1,541,412,1203,1615,2,targOff,13
2,18,959,540.4,1440,-262,1178,1,waiting,13
2,18,768.3,539.3,408,1223,1631,2,targOff,13
2,19,953.1,539.8,1693,-259,1434,1,waiting,13
2,19,778.3,543,413,1463,1876,2,targOff,13
2,20,954.8,545.2,1457,-254,1203,1,waiting,13
2,20,1126.2,550,469,1228,1697,2,targOff,13
2,21,973.2,557.5,211,-38,173,1,waiting,13
2,21,953.9,550.6,1112,193,1305,2,waiting,13
2,21,1124.1,551.1,450,1330,1780,3,targOff,13
2,22,956.7,548,1504,-249,1255,1,waiting,13
2,22,782.6,542.3,427,1287,1714,2,targOff,13
2,23,953.4,546.4,1564,-248,1316,1,waiting,13
2,23,789.1,541.6,446,1351,1797,2,targOff,13
2,24,954.4,546.4,1431,-258,1173,1,waiting,13
2,24,786.1,547.4,262,1205,1467,2,targOff,13
2,24,762.8,551.3,186,1475,1661,3,targOff,13
2,25,958.5,548.4,1114,-30,1084,1,waiting,13
2,25,1117,546.5,422,1109,1531,2,targOff,13
2,26,966.2,551.8,210,-38,172,1,waiting,13
2,26,953.5,551.6,914,189,1103,2,waiting,13
2,26,783.5,551.3,476,1138,1614,3,targOff,13
2,27,960.8,540,1819,-267,1552,1,waiting,13
2,27,773.3,538.4,297,1583,1880,2,targOff,13
2,28,957.5,534.5,1458,-259,1199,1,waiting,13
2,28,1153,534.4,451,1226,1677,2,targOff,13
2,29,953.3,546.1,1481,-263,1218,1,waiting,13
2,29,1111.2,545.6,421,1243,1664,2,targOff,13
2,30,951,549.4,1199,-24,1175,1,waiting,13
2,30,1118.1,559.3,466,1198,1664,2,targOff,13
2,31,964.1,557.3,146,-107,39,1,waiting,13
2,31,955.6,554.5,1164,57,1221,2,waiting,13
2,31,781.2,556.1,463,1268,1731,3,targOff,13
2,32,961.4,543.6,1460,-33,1427,1,waiting,13
2,32,790.8,546.8,467,1463,1930,2,targOff,13
2,33,968.1,541.3,1127,-50,1077,1,waiting,13
2,33,764.7,547.3,434,1113,1547,2,targOff,13
2,34,965,546.8,1656,-258,1398,1,waiting,13
2,34,1139.9,538.7,473,1424,1897,2,targOff,13
2,35,959.1,546.3,1496,-254,1242,1,waiting,13
2,35,791.1,542.8,468,1279,1747,2,targOff,13
2,36,950.1,554.5,1522,-260,1262,1,waiting,13
2,36,1125.7,536.8,489,1288,1777,2,targOff,13
2,37,962.2,548.8,1345,-253,1092,1,waiting,13
2,37,1134.8,546.2,428,1120,1548,2,targOff,13
2,38,961.5,550.1,1416,-31,1385,1,waiting,13
2,38,1123.2,542.5,448,1431,1879,2,targOff,13
2,39,957.8,551.3,1609,-260,1349,1,waiting,13
2,39,1127.4,541.1,473,1374,1847,2,targOff,13
2,40,964.6,540.5,1580,-253,1327,1,waiting,13
2,40,776.8,548.5,452,1362,1814,2,targOff,13
2,1,956,554.3,238,23,261,1,waiting,14
2,1,956.4,540.5,1131,269,1400,2,waiting,14
2,1,747.2,530.9,213,1451,1664,3,targOff,14
2,2,954.4,542.6,1908,-261,1647,1,waiting,14
2,3,951.5,539.6,1677,-30,1647,1,waiting,14
2,4,952.7,538.5,1826,-262,1564,1,waiting,14
2,5,965,547.2,1748,-268,1480,1,waiting,14
2,6,982.6,539.6,432,-263,169,1,waiting,14
2,6,964.3,549.5,1370,177,1547,2,waiting,14
2,7,959.3,548.4,2175,-261,1914,1,waiting,14
2,8,954.7,550.3,1793,-261,1532,1,waiting,14
2,9,958.1,554.9,1838,-259,1579,1,waiting,14
2,10,956.4,548.2,1427,1,1428,1,waiting,14
2,11,952.2,550.5,1964,-251,1713,1,waiting,14
2,11,939.8,548.7,165,1732,1897,2,targOff,14
2,12,952.8,548.9,1728,-264,1464,1,waiting,14
2,13,945.4,545,2097,-250,1847,1,waiting,14
2,14,957.9,542.3,1909,-262,1647,1,waiting,14
2,15,952.8,551.6,1862,-249,1613,1,waiting,14
2,16,947.9,544.6,1995,-265,1730,1,waiting,14
2,17,957.2,548,1511,-48,1463,1,waiting,14
2,18,955.5,546.7,1707,-260,1447,1,waiting,14
2,19,959.4,544.1,1790,-43,1747,1,waiting,14
2,20,959.3,544.2,1906,-260,1646,1,waiting,14
2,21,959.1,548.6,1767,-253,1514,1,waiting,14
2,22,960.2,550.8,1182,32,1214,1,waiting,14
2,23,850.5,560.2,152,-145,7,1,waiting,14
2,23,952.1,551.4,1819,29,1848,2,waiting,14
2,24,950.3,544,1883,-252,1631,1,waiting,14
2,25,948.2,555.4,1947,-249,1698,1,waiting,14
2,26,954,549.5,1777,-261,1516,1,waiting,14
2,26,776.1,549.1,225,1573,1798,2,targOff,14
2,27,959,545.3,1749,-189,1560,1,waiting,14
2,28,948.5,550.4,1900,-253,1647,1,waiting,14
2,29,955.8,552,1973,-259,1714,1,waiting,14
2,30,955.6,556.3,1681,-101,1580,1,waiting,14
2,31,955.9,551.9,2173,-259,1914,1,waiting,14
2,32,955.7,553,1984,-253,1731,1,waiting,14
2,33,956.1,553.1,2014,-103,1911,1,waiting,14
2,34,954.6,553.1,1709,-262,1447,1,waiting,14
2,35,954.4,559.9,1124,-253,871,1,waiting,14
2,35,957.7,555.5,499,887,1386,2,dotOff,14
2,35,1062.9,545.9,106,1408,1514,3,targOff,14
2,36,957.4,558.5,1470,-27,1443,1,waiting,14
2,37,965.3,568.4,254,-254,0,1,waiting,14
2,37,963.5,551.3,1772,9,1781,2,waiting,14
2,38,960.4,558,1940,-26,1914,1,waiting,14
2,39,972.7,544.1,149,-32,117,1,waiting,14
2,39,941.7,549.3,1677,137,1814,2,waiting,14
2,40,956.6,551.6,2080,-266,1814,1,waiting,14
2,1,1031.3,553.3,263,-254,9,1,waiting,15
2,1,951.5,547.3,1031,34,1065,2,waiting,15
2,1,1127.8,541.3,388,1093,1481,3,targOff,15
2,2,949.4,551.4,1286,-252,1034,1,waiting,15
2,2,776.1,549.3,498,1082,1580,2,targOff,15
2,3,955.2,543.7,1597,-261,1336,1,waiting,15
2,3,1133.5,545.2,503,1361,1864,2,targOff,15
2,4,956.5,555.3,1449,-250,1199,1,waiting,15
2,4,789.2,555.6,468,1247,1715,2,targOff,15
2,5,955.2,545.8,1160,-158,1002,1,waiting,15
2,5,776.7,545.6,449,1049,1498,2,targOff,15
2,6,943.7,545.2,266,-27,239,1,waiting,15
2,6,967.5,546.7,151,248,399,2,waiting,15
2,6,956.7,545.3,917,418,1335,3,waiting,15
2,6,1135.8,551.5,436,1361,1797,4,targOff,15
2,7,953.1,543.3,1627,-258,1369,1,waiting,15
2,7,785.5,565.5,447,1415,1862,2,targOff,15
2,8,954.1,553.9,144,-144,0,1,waiting,15
2,8,955.7,535.5,1782,16,1798,2,waiting,15
2,9,975.6,537.3,1155,-4,1151,1,waiting,15
2,9,796,539.4,446,1201,1647,2,targOff,15
2,10,946.5,538.9,922,-60,862,1,waiting,15
2,10,940.6,533.5,419,878,1297,2,waiting,15
2,10,1131.9,543.3,475,1323,1798,3,targOff,15
2,11,951.8,527.4,1496,-260,1236,1,waiting,15
2,11,786.2,543.4,170,1267,1437,2,targOff,15
2,11,783.3,547.8,302,1446,1748,3,targOff,15
2,12,952,551.5,1067,-49,1018,1,waiting,15
2,12,1119.8,546.9,437,1048,1485,2,targOff,15
2,13,944.3,559.9,1252,-46,1206,1,waiting,15
2,13,1126.2,550.6,446,1231,1677,2,targOff,15
2,14,953.4,561.3,1258,-259,999,1,waiting,15
2,14,1124.1,545.8,455,1025,1480,2,targOff,15
2,15,962.7,553.4,1478,-265,1213,1,waiting,15
2,15,1125.2,537.5,214,1250,1464,2,targOff,15
2,16,956.3,553.5,1368,-254,1114,1,waiting,15
2,16,1101.5,553.3,410,1138,1548,2,targOff,15
2,17,896,553.1,267,-259,8,1,waiting,15
2,17,949.2,553.8,1411,22,1433,2,waiting,15
2,17,780.9,559.7,454,1477,1931,3,targOff,15
2,18,949.1,554,1548,-253,1295,1,waiting,15
2,18,1127.2,550.7,441,1323,1764,2,targOff,15
2,19,954.2,548.1,1674,-258,1416,1,waiting,15
2,19,1132.7,555.6,451,1446,1897,2,targOff,15
2,20,948,550.3,1258,-58,1200,1,waiting,15
2,20,783.3,546.2,450,1230,1680,2,targOff,15
2,21,949.3,550.3,1305,-200,1105,1,waiting,15
2,21,1119.8,552,306,1140,1446,2,targOff,15
2,22,946.5,554.5,1450,-261,1189,1,waiting,15
2,22,938.1,547.4,196,1208,1404,2,dotOff,15
2,22,1119.4,547.1,446,1435,1881,3,targOff,15
2,23,951,551.5,1247,-259,988,1,waiting,15
2,23,1117,549,418,1012,1430,2,targOff,15
2,24,953.7,547,1203,-180,1023,1,waiting,15
2,24,790.5,548.2,481,1066,1547,2,targOff,15
2,25,951.1,547.3,1375,-50,1325,1,waiting,15
2,25,1128.5,540.2,480,1350,1830,2,targOff,15
2,26,952.5,553.6,1154,-81,1073,1,waiting,15
2,26,789.3,559.6,305,1118,1423,2,targOff,15
2,26,766.9,547.5,134,1444,1578,3,targOff,15
2,27,958.6,548.8,1506,-253,1253,1,waiting,15
2,27,1134.3,549,466,1281,1747,2,targOff,15
2,28,956.1,554.2,1353,-260,1093,1,waiting,15
2,28,1128.2,548.6,463,1118,1581,2,targOff,15
2,29,947,563.9,1263,-259,1004,1,waiting,15
2,29,1114.5,552.8,446,1030,1476,2,targOff,15
2,30,965.7,547.6,1184,-41,1143,1,waiting,15
2,30,1132.8,550.1,437,1175,1612,2,targOff,15
2,31,952.1,558.2,1218,-260,958,1,waiting,15
2,31,781.7,569.9,456,990,1446,2,targOff,15
2,32,964.5,545.6,1661,-249,1412,1,waiting,15
2,32,796.4,557.3,441,1454,1895,2,targOff,15
2,33,952.6,547.5,1449,-267,1182,1,waiting,15
2,33,791.3,557.2,469,1228,1697,2,targOff,15
2,34,957.1,556,1506,-259,1247,1,waiting,15
2,34,1123,554.4,436,1274,1710,2,targOff,15
2,35,949.6,548.2,1518,-260,1258,1,waiting,15
2,35,1114.5,553.6,462,1283,1745,2,targOff,15
2,36,949.4,556.8,1357,-63,1294,1,waiting,15
2,36,1119.1,562.6,461,1320,1781,2,targOff,15
2,37,963.6,547.9,206,-32,174,1,waiting,15
2,37,948.3,548.2,974,183,1157,2,waiting,15
2,37,790.7,554.2,458,1189,1647,3,targOff,15
2,38,953.7,545.7,1453,-248,1205,1,waiting,15
2,38,1125.8,555.2,451,1230,1681,2,targOff,15
2,39,949.2,554.1,1405,-258,1147,1,waiting,15
2,39,788,563.1,437,1193,1630,2,targOff,15
2,40,952.3,554,1378,-40,1338,1,waiting,15
2,40,1135.3,547.6,482,1366,1848,2,targOff,15
2,1,1061.5,531.2,202,-199,3,1,waiting,16
2,1,967.3,539.4,1405,26,1431,2,waiting,16
2,2,958.6,538.9,1835,-264,1571,1,waiting,16
2,3,954.9,539.2,1742,-261,1481,1,waiting,16
2,4,958.6,546.3,1848,-251,1597,1,waiting,16
2,5,960.7,547.4,2041,-261,1780,1,waiting,16
2,6,962.7,532.6,2030,-266,1764,1,waiting,16
2,7,957.7,554.2,2045,-264,1781,1,waiting,16
2,8,954.8,540,877,-208,669,1,waiting,16
2,8,954.1,553.7,270,843,1113,2,waiting,16
2,9,960,548.3,1434,-3,1431,1,waiting,16
2,10,963.3,542.2,1695,-248,1447,1,waiting,16
2,11,954.9,529.3,691,-256,435,1,waiting,16
2,11,955.5,555.6,368,612,980,2,waiting,16
2,12,957.1,547.6,2071,-190,1881,1,waiting,16
2,13,952.7,553.4,1721,-57,1664,1,waiting,16
2,14,963.3,538.4,1365,-248,1117,1,waiting,16
2,14,949.2,530,616,1132,1748,2,dotOff,16
2,15,962.6,540.9,1809,-28,1781,1,waiting,16
2,16,958.7,538.8,1751,-254,1497,1,waiting,16
2,17,959.9,551,1715,-268,1447,1,waiting,16
2,18,961.4,545.4,1656,-252,1404,1,waiting,16
2,18,955.3,551.3,333,1420,1753,2,targOff,16
2,18,968.8,542.1,143,1771,1914,3,targOff,16
2,19,952.1,540,271,-76,195,1,waiting,16
2,19,947.7,557.8,1480,218,1698,2,waiting,16
2,20,948.7,547.2,1855,-260,1595,1,waiting,16
2,21,952.9,541.1,133,-40,93,1,waiting,16
2,21,950.9,548,1813,101,1914,2,waiting,16
2,22,952.1,554.3,1741,-260,1481,1,waiting,16
2,23,957.5,551.5,1680,-16,1664,1,waiting,16
2,24,957.1,546.8,272,-266,6,1,waiting,16
2,24,947.9,544.4,321,14,335,2,waiting,16
2,24,948.5,548.3,619,478,1097,3,waiting,16
2,25,948.9,549.9,1779,1,1780,1,waiting,16
2,26,949.2,545.1,1925,-261,1664,1,waiting,16
2,27,953,621.8,200,-47,153,1,waiting,16
2,27,957.5,551.7,1453,160,1613,2,waiting,16
2,28,953.9,553.4,1692,-261,1431,1,waiting,16
2,29,952.5,558.3,1715,-251,1464,1,waiting,16
2,30,957.3,548.6,2133,-252,1881,1,waiting,16
2,31,950.5,555.7,2122,-257,1865,1,waiting,16
2,32,949.8,551.6,1664,-67,1597,1,waiting,16
2,32,944.4,575.1,150,1747,1897,2,targOff,16
2,33,913.1,567.1,177,118,295,1,waiting,16
2,33,944,563.6,556,308,864,2,waiting,16
2,34,964.4,547,173,-158,15,1,waiting,16
2,34,955.6,547,1666,31,1697,2,waiting,16
2,35,949.7,558.8,1611,-32,1579,1,waiting,16
2,36,955.2,566.8,1626,4,1630,1,waiting,16
2,37,956.7,536.3,879,-260,619,1,waiting,16
2,37,958.8,537.6,369,626,995,2,waiting,16
2,37,956.6,552.4,554,1006,1560,3,dotOff,16
2,38,955.2,553.9,2012,-248,1764,1,waiting,16
2,39,949,550.7,276,-40,236,1,waiting,16
2,39,955.4,547.3,1603,244,1847,2,waiting,16
2,40,959.6,529.5,268,-257,11,1,waiting,16
2,40,955.1,542.8,1766,31,1797,2,waiting,16
2,1,943,554.1,295,-250,45,1,waiting,17
2,1,964.4,545.1,195,59,254,2,waiting,17
2,1,956.1,543.7,744,261,1005,3,waiting,17
2,1,1119.7,539.9,399,1031,1430,4,targOff,17
2,2,953.6,553,1209,-252,957,1,waiting,17
2,2,781.9,541.4,511,1003,1514,2,targOff,17
2,3,953.7,552.7,1108,-32,1076,1,waiting,17
2,3,818.1,553.9,302,1112,1414,2,dotOff,17
2,3,774.6,557.4,301,1446,1747,3,targOff,17
2,4,954.2,557.6,347,-257,90,1,waiting,17
2,4,953.3,557.8,1018,99,1117,2,waiting,17
2,4,782.2,549,411,1183,1594,3,targOff,17
2,5,948.4,549.3,1538,-250,1288,1,waiting,17
2,5,1123.4,555.7,412,1317,1729,2,targOff,17
2,6,950.4,555.2,557,-248,309,1,waiting,17
2,6,942.9,558.4,253,316,569,2,waiting,17
2,6,955.2,555.7,910,587,1497,3,waiting,17
2,7,854.3,519.1,196,547,743,1,waiting,17
2,7,951.1,550.4,363,780,1143,2,waiting,17
2,8,955.8,536.8,1162,-158,1004,1,waiting,17
2,8,785.3,535.9,401,1063,1464,2,targOff,17
2,9,955.5,542.6,1455,-259,1196,1,waiting,17
2,9,1132.1,551.4,475,1221,1696,2,targOff,17
2,10,954,548.3,1319,-31,1288,1,waiting,17
2,10,1137.8,554.1,479,1318,1797,2,targOff,17
2,11,959.9,548.7,1396,-29,1367,1,waiting,17
2,11,794.8,538.4,447,1413,1860,2,targOff,17
2,12,955.5,544.3,1243,-35,1208,1,waiting,17
2,12,1128.1,548.3,448,1233,1681,2,targOff,17
2,13,950.5,549.4,1343,-261,1082,1,waiting,17
2,13,1090.8,550.8,276,1106,1382,2,targOff,17
2,13,1134.2,539.8,94,1404,1498,3,targOff,17
2,14,953.8,555.3,924,-234,690,1,waiting,17
2,14,770.9,560.6,358,722,1080,2,waiting,17
2,15,975.1,539.7,123,-106,17,1,waiting,17
2,15,951.3,550.3,1152,38,1190,2,waiting,17
2,15,1101.2,556,413,1218,1631,3,targOff,17
2,16,950.1,548.7,683,-15,668,1,waiting,17
2,16,948.6,549.6,335,676,1011,2,waiting,17
2,16,1117.1,555.6,376,1051,1427,3,targOff,17
2,17,949.7,569.9,1304,-32,1272,1,waiting,17
2,17,1110.2,570.1,430,1300,1730,2,targOff,17
2,18,1003.9,558.2,133,-133,0,1,waiting,17
2,18,954.2,557.7,1219,29,1248,2,waiting,17
2,18,774.3,555.6,432,1295,1727,3,targOff,17
2,19,940.7,548.2,476,-260,216,1,waiting,17
2,19,962.7,556.4,831,234,1065,2,waiting,17
2,19,773.1,551.1,407,1124,1531,3,targOff,17
2,20,954.3,560,1040,-10,1030,1,waiting,17
2,20,806.1,570.6,403,1061,1464,2,targOff,17
2,21,954.2,558,1719,-260,1459,1,waiting,17
2,22,952.1,555.7,1394,-21,1373,1,waiting,17
2,22,1119.6,555.9,467,1413,1880,2,targOff,17
2,23,953,557.8,1369,-252,1117,1,waiting,17
2,23,1129,545.4,432,1149,1581,2,targOff,17
2,24,948,566.1,1356,-255,1101,1,waiting,17
2,24,775.9,555.8,399,1148,1547,2,targOff,17
2,25,953.5,553.8,1428,-259,1169,1,waiting,17
2,25,788.3,561.6,477,1204,1681,2,targOff,17
2,26,951.2,557.4,1451,-47,1404,1,waiting,17
2,26,781.2,553,366,1448,1814,2,targOff,17
2,27,952.6,546.2,1295,-259,1036,1,waiting,17
2,27,1128,555.7,449,1062,1511,2,targOff,17
2,28,953.3,552.8,1013,-64,949,1,waiting,17
2,28,790.4,549.6,463,980,1443,2,targOff,17
2,29,936.7,552.1,1778,-258,1520,1,waiting,17
2,29,828.8,545.4,128,1553,1681,2,targOff,17
2,30,947.3,553.7,1104,24,1128,1,waiting,17
2,30,776.2,551.6,440,1174,1614,2,targOff,17
2,31,970.8,556.7,209,-26,183,1,waiting,17
2,31,942.2,558.7,789,195,984,2,waiting,17
2,31,767.4,565.4,434,1030,1464,3,targOff,17
2,32,950.6,555.1,1601,-262,1339,1,waiting,17
2,32,1114.8,551.8,479,1368,1847,2,targOff,17
2,33,948.7,549.8,983,-67,916,1,waiting,17
2,33,935.3,552,131,935,1066,2,dotOff,17
2,33,1132.3,551.1,219,1092,1311,3,targOff,17
2,33,1133.5,563.8,83,1448,1531,4,targOff,17
2,34,957.8,555.2,1084,-1,1083,1,waiting,17
2,34,1116.7,556.2,553,1111,1664,2,dotOff,17
2,35,949.7,545.6,676,-258,418,1,waiting,17
2,35,945.7,551.3,525,437,962,2,waiting,17
2,35,1124,553,194,987,1181,3,waiting,17
2,36,927.3,563,274,-35,239,1,waiting,17
2,36,945.6,569.3,877,254,1131,2,waiting,17
2,36,942.2,573.8,199,1244,1443,3,targOff,17
2,36,1122.7,553.3,201,1480,1681,4,targOff,17
2,37,934.4,553,144,-71,73,1,waiting,17
2,37,953.1,561.3,269,91,360,2,waiting,17
2,37,947.3,562.4,817,378,1195,3,waiting,17
2,37,1114.7,552.6,469,1224,1693,4,targOff,17
2,38,956.9,559.7,1100,-44,1056,1,waiting,17
2,38,784.9,566.9,404,1110,1514,2,targOff,17
2,39,946.6,559,276,-50,226,1,waiting,17
2,39,956.3,566.6,834,246,1080,2,waiting,17
2,39,1130.9,557.3,470,1111,1581,3,targOff,17
2,40,951.1,563,1690,-260,1430,1,waiting,17
2,40,1088.7,563.4,321,1455,1776,2,targOff,17
2,40,1132.1,562.7,58,1801,1859,3,targOff,17
2,1,1092.7,543,264,-254,10,1,waiting,18
2,1,953.8,549,1512,36,1548,2,waiting,18
2,2,954.1,553,1782,-251,1531,1,waiting,18
2,3,949.6,552,1709,-261,1448,1,waiting,18
2,4,950.5,558.5,1885,12,1897,1,waiting,18
2,5,951.8,570.3,1551,-4,1547,1,waiting,18
2,6,957.4,557.6,1911,-247,1664,1,waiting,18
2,7,955.6,556,1777,-80,1697,1,waiting,18
2,8,960.3,556.9,1836,-255,1581,1,waiting,18
2,9,953.8,556.6,2135,-259,1876,1,waiting,18
2,10,951.9,554.4,2036,-255,1781,1,waiting,18
2,11,950.2,553.5,1745,-56,1689,1,waiting,18
2,11,920.1,560,179,1701,1880,2,targOff,18
2,12,952.2,556.4,1730,-253,1477,1,waiting,18
2,12,1111.7,546.5,198,1499,1697,2,targOff,18
2,13,906.7,584.5,262,-251,11,1,waiting,18
2,13,942.6,562.3,1676,21,1697,2,waiting,18
2,14,938.2,561.4,1180,-165,1015,1,waiting,18
2,14,952.1,641.6,99,1365,1464,2,targOff,18
2,15,951.5,555.5,1918,-21,1897,1,waiting,18
2,16,940.6,555.2,1494,3,1497,1,waiting,18
2,17,936.9,565.3,1570,-262,1308,1,waiting,18
2,17,938.3,562.3,508,1322,1830,2,targOff,18
2,18,935.1,559.6,456,-183,273,1,waiting,18
2,18,946,559.7,1388,292,1680,2,waiting,18
2,19,952.7,563.3,242,-23,219,1,waiting,18
2,19,942,561.4,1605,226,1831,2,waiting,18
2,20,944.5,557.1,2025,-246,1779,1,waiting,18
2,21,937.9,561.6,556,21,577,1,waiting,18
2,21,947.5,570.9,1312,585,1897,2,waiting,18
2,22,942.6,556.1,1656,-242,1414,1,waiting,18
2,23,937.6,563.9,2086,-260,1826,1,waiting,18
2,24,950.7,547.1,1473,5,1478,1,waiting,18
2,25,936.7,553.7,1980,-250,1730,1,waiting,18
2,26,946.5,548.3,2018,-254,1764,1,waiting,18
2,27,937.7,549.9,1675,-45,1630,1,waiting,18
2,28,940.5,554.6,1573,-264,1309,1,waiting,18
2,28,876.6,533.1,154,1327,1481,2,targOff,18
2,29,937.3,554.5,1844,-264,1580,1,waiting,18
2,30,935,552.1,2029,-248,1781,1,waiting,18
2,31,935.8,551.8,2084,-253,1831,1,waiting,18
2,32,937.6,546.7,1966,-252,1714,1,waiting,18
2,33,942.2,555.2,1474,-27,1447,1,waiting,18
2,34,935.5,560.7,1971,-257,1714,1,waiting,18
2,35,944.6,556.2,1784,-236,1548,1,waiting,18
2,36,946.8,559.9,1945,-248,1697,1,waiting,18
2,37,940.6,558.1,1958,-260,1698,1,waiting,18
2,38,935.4,555.9,312,-33,279,1,waiting,18
2,38,936,565.1,1400,298,1698,2,waiting,18
2,39,937.2,560.4,1613,-17,1596,1,waiting,18
2,39,1016.7,550,133,1615,1748,2,targOff,18
2,40,937.1,553.3,2077,-263,1814,1,waiting,18
2,1,1018.1,549.7,277,-254,23,1,waiting,19
2,1,939.4,548.5,1261,47,1308,2,waiting,19
2,1,769,554.8,457,1357,1814,3,targOff,19
2,2,941.1,559.5,923,9,932,1,waiting,19
2,2,935.6,551.2,84,950,1034,2,dotOff,19
2,2,1115.4,550.7,450,1061,1511,3,targOff,19
2,3,941.9,553.2,1655,-262,1393,1,waiting,19
2,3,752.9,563.3,375,1439,1814,2,targOff,19
2,4,939.2,546.4,1337,-171,1166,1,waiting,19
2,4,772.3,534.3,246,1202,1448,2,targOff,19
2,5,930.2,547.8,684,-54,630,1,waiting,19
2,5,933,548.2,490,654,1144,2,waiting,19
2,5,1106.4,554.8,443,1171,1614,3,targOff,19
2,6,1037.6,447.7,102,40,142,1,waiting,19
2,6,959.5,554.8,101,187,288,2,waiting,19
2,6,918.9,544.8,154,318,472,3,waiting,19
2,6,948.9,551.2,348,494,842,4,waiting,19
2,7,943,561,1356,-10,1346,1,waiting,19
2,7,1114.6,551.6,441,1373,1814,2,targOff,19
2,8,938.5,556.2,1374,-259,1115,1,waiting,19
2,8,1123.2,553,417,1147,1564,2,targOff,19
2,9,938.8,553.6,1450,-255,1195,1,waiting,19
2,9,764.4,552.2,474,1240,1714,2,targOff,19
2,10,949.5,559.1,1073,0,1073,1,waiting,19
2,10,1099.3,564.1,481,1098,1579,2,waiting,19
2,10,1120.5,562.7,281,1598,1879,3,targOff,19
2,11,959,561.2,150,-54,96,1,waiting,19
2,11,932.8,555.7,1044,113,1157,2,waiting,19
2,11,784.6,564,426,1203,1629,3,targOff,19
2,12,931.6,557.4,1428,-253,1175,1,waiting,19
2,12,772.4,565.6,438,1209,1647,2,targOff,19
2,13,938,560.9,1655,-253,1402,1,waiting,19
2,13,776.7,574.3,434,1447,1881,2,targOff,19
2,14,935,552.1,612,-171,441,1,waiting,19
2,14,939.1,550.5,834,459,1293,2,waiting,19
2,14,1109.7,552.7,464,1317,1781,3,targOff,19
2,15,938.3,551.2,541,16,557,1,waiting,19
2,15,932.6,556.4,640,581,1221,2,waiting,19
2,15,1101.5,551.3,397,1247,1644,3,targOff,19
2,16,938.7,557.5,1291,10,1301,1,waiting,19
2,16,772.8,561.2,435,1362,1797,2,targOff,19
2,17,937.4,554.1,1049,-71,978,1,waiting,19
2,17,1113.7,544.8,429,1002,1431,2,targOff,19
2,18,939.6,555,1190,-11,1179,1,waiting,19
2,18,1111.1,561.7,436,1208,1644,2,targOff,19
2,19,952.4,556.3,1081,-3,1078,1,waiting,19
2,19,1113.6,547.2,443,1104,1547,2,targOff,19
2,20,942.2,543.7,190,-175,15,1,waiting,19
2,20,939.3,567.7,514,25,539,2,waiting,19
2,20,927.7,559,483,547,1030,3,waiting,19
2,20,779.1,566.7,441,1073,1514,4,targOff,19
2,21,936.1,560.7,1496,-262,1234,1,waiting,19
2,21,777.8,567.7,437,1260,1697,2,targOff,19
2,22,941.7,557.6,1275,-251,1024,1,waiting,19
2,22,1110.9,555.7,431,1048,1479,2,targOff,19
2,23,930,565.5,1360,18,1378,1,waiting,19
2,23,780.2,560.6,456,1409,1865,2,targOff,19
2,24,943.6,561.4,252,-250,2,1,waiting,19
2,24,934.1,557.2,1116,20,1136,2,waiting,19
2,24,1126.5,558.7,462,1169,1631,3,targOff,19
2,25,935.5,555.3,1498,-261,1237,1,waiting,19
2,25,1110.1,558.5,431,1263,1694,2,targOff,19
2,26,936.1,550.4,1205,6,1211,1,waiting,19
2,26,774.2,565.6,425,1256,1681,2,targOff,19
2,27,930.3,561.1,1285,-262,1023,1,waiting,19
2,27,1119.4,558,646,1051,1697,2,waiting,19
2,28,937.3,560,498,24,522,1,waiting,19
2,28,926.8,564.2,505,538,1043,2,waiting,19
2,28,752.8,567.4,405,1099,1504,3,targOff,19
2,29,940.9,554.2,1135,1,1136,1,waiting,19
2,29,756.9,566.3,414,1184,1598,2,targOff,19
2,30,935.2,556.4,474,-261,213,1,waiting,19
2,30,932.5,563.4,974,229,1203,2,waiting,19
2,30,764.4,569.3,443,1232,1675,3,targOff,19
2,31,937.3,554.2,1363,-261,1102,1,waiting,19
2,31,941.7,554.4,259,1119,1378,2,dotOff,19
2,31,751.4,556.2,325,1422,1747,3,targOff,19
2,32,934.3,560.5,1533,-263,1270,1,waiting,19
2,32,1070.6,558,271,1293,1564,2,targOff,19
2,32,1111.6,547.4,111,1586,1697,3,targOff,19
2,33,940.5,553.8,1462,-264,1198,1,waiting,19
2,33,780.1,561.8,467,1230,1697,2,targOff,19
2,34,938,563.7,1509,-252,1257,1,waiting,19
2,34,781.3,563.7,410,1288,1698,2,targOff,19
2,35,935.5,565.5,1323,-265,1058,1,waiting,19
2,35,777.9,556.3,424,1091,1515,2,targOff,19
2,36,939.3,558.9,1433,-260,1173,1,waiting,19
2,36,1108.5,555.2,449,1198,1647,2,targOff,19
2,37,955.3,550.5,282,-259,23,1,waiting,19
2,37,943.4,546.6,974,41,1015,2,waiting,19
2,37,775.5,557.8,447,1048,1495,3,targOff,19
2,38,938.3,555.2,1465,-253,1212,1,waiting,19
2,38,1109.3,565.6,460,1237,1697,2,targOff,19
2,39,932.8,553.8,1246,-6,1240,1,waiting,19
2,39,776.3,558.7,396,1285,1681,2,targOff,19
2,40,937.1,553.7,1410,-33,1377,1,waiting,19
2,40,1110,548.9,439,1408,1847,2,targOff,19
2,1,964.7,557.8,244,-192,52,1,waiting,20
2,1,939.2,553.7,1587,73,1660,2,waiting,20
2,2,938.5,549.1,1844,-260,1584,1,waiting,20
2,2,944.8,545.7,53,1591,1644,2,targOff,20
2,3,935.6,548.1,1912,-248,1664,1,waiting,20
2,4,942.9,550.7,2145,-264,1881,1,waiting,20
2,5,938,550.1,877,-261,616,1,waiting,20
2,5,951.2,551.3,905,623,1528,2,waiting,20
2,6,940.6,550.8,1714,-262,1452,1,waiting,20
2,6,791.1,552.6,195,1486,1681,2,targOff,20
2,7,934.8,560.8,1024,39,1063,1,waiting,20
2,8,949.1,542.4,2005,-258,1747,1,waiting,20
2,9,947.3,547,1870,-259,1611,1,waiting,20
2,10,942.3,546.8,1964,-250,1714,1,waiting,20
2,11,961.4,541.7,306,-263,43,1,waiting,20
2,11,952.6,556.9,1707,59,1766,2,waiting,20
2,11,961.8,544.2,98,1783,1881,3,targOff,20
2,12,943.8,554.2,1872,-260,1612,1,waiting,20
2,13,948.2,550.8,1991,-260,1731,1,waiting,20
2,14,938.9,554.7,1792,-251,1541,1,waiting,20
2,15,945,546.9,2002,-258,1744,1,waiting,20
2,16,947.6,545.3,1554,-40,1514,1,waiting,20
2,17,942.5,547.8,2081,-250,1831,1,waiting,20
2,18,947.7,545.8,1770,-139,1631,1,waiting,20
2,19,943.9,548.8,1795,-260,1535,1,waiting,20
2,19,942.7,545,188,1543,1731,2,targOff,20
2,20,943.6,547.7,1588,-91,1497,1,waiting,20
2,21,955,557.6,242,-47,195,1,waiting,20
2,21,940.6,556.3,1536,211,1747,2,waiting,20
2,22,948.5,546.6,1524,13,1537,1,waiting,20
2,23,947.6,537.5,2018,-254,1764,1,waiting,20
2,24,941.8,540.8,2072,-208,1864,1,waiting,20
2,25,937.7,553.1,1706,-259,1447,1,waiting,20
2,26,946.3,546.6,1780,-33,1747,1,waiting,20
2,27,943,542.4,1539,-9,1530,1,waiting,20
2,28,952.4,539.7,1726,-12,1714,1,waiting,20
2,29,935.6,554.9,282,-267,15,1,waiting,20
2,29,946.1,556.4,1084,34,1118,2,waiting,20
2,29,939.9,553.8,647,1133,1780,3,dotOff,20
2,30,934.9,555.5,282,-263,19,1,waiting,20
2,30,940.6,551.9,1662,36,1698,2,waiting,20
2,31,944.4,547.4,1753,-260,1493,1,waiting,20
2,32,938.5,545.2,1720,-261,1459,1,waiting,20
2,32,939.2,538.6,22,1466,1488,2,targOff,20
2,32,956.2,541.9,47,1617,1664,3,targOff,20
2,33,932.9,550.4,799,81,880,1,waiting,20
2,34,942.2,551.5,1599,-2,1597,1,waiting,20
2,35,936.1,550.5,1710,-262,1448,1,waiting,20
2,36,937.3,560.3,1810,-165,1645,1,waiting,20
2,37,945.5,541.8,1768,-258,1510,1,waiting,20
2,38,945.5,545.3,1820,-258,1562,1,waiting,20
2,39,937,562.1,1761,-247,1514,1,waiting,20
2,40,943.7,555.4,2089,-259,1830,1,waiting,20
