person,trial,x,y,dur,on,off,n,timeInt,block
13,1,922.3,552.4,290,-268,22,1,waiting,1
13,1,941.8,558.2,1163,29,1192,2,waiting,1
13,1,759.6,559.2,808,1223,2031,3,dotOff,1
13,2,953,547.1,1777,-269,1508,1,waiting,1
13,2,1135.6,562.8,737,1545,2282,2,dotOff,1
13,3,945.9,551.3,1778,-274,1504,1,waiting,1
13,3,1124.4,553.9,659,1539,2198,2,dotOff,1
13,4,947.5,563.4,1376,-274,1102,1,waiting,1
13,4,764.5,549.1,724,1141,1865,2,dotOff,1
13,5,950,539.2,1585,-274,1311,1,waiting,1
13,5,778.6,555,693,1338,2031,2,dotOff,1
13,6,948.2,547.4,1791,-269,1522,1,waiting,1
13,6,1116.8,566.4,723,1559,2282,2,dotOff,1
13,7,941.6,556.3,1185,-24,1161,1,waiting,1
13,7,762.5,555.7,670,1195,1865,2,dotOff,1
13,8,944.3,557.8,1591,-277,1314,1,waiting,1
13,8,1115,551.1,770,1342,2112,2,dotOff,1
13,9,944.3,551.8,1869,-274,1595,1,waiting,1
13,9,1080.8,553.2,188,1621,1809,2,dotOff,1
13,9,1111.8,560.5,459,1822,2281,3,targOff,1
13,10,978,544.4,210,-58,152,1,waiting,1
13,10,946.9,556.5,994,164,1158,2,waiting,1
13,10,745.4,554.3,671,1194,1865,3,dotOff,1
13,11,940.8,585.8,1356,-275,1081,1,waiting,1
13,12,933.5,568.1,1698,-273,1425,1,waiting,1
13,12,1114.8,562.6,736,1462,2198,2,dotOff,1
13,13,938.8,560.8,1549,-21,1528,1,waiting,1
13,13,778.5,554,727,1554,2281,2,dotOff,1
13,14,942.5,563.4,1686,-273,1413,1,waiting,1
13,14,772.2,561.2,759,1439,2198,2,dotOff,1
13,15,940,560.2,1470,-273,1197,1,waiting,1
13,15,1124.7,559.4,714,1234,1948,2,dotOff,1
13,16,941.5,557.2,1771,-272,1499,1,waiting,1
13,16,1112.3,561,753,1528,2281,2,dotOff,1
13,17,961.2,562.4,128,-42,86,1,waiting,1
13,17,940.1,557.2,1075,94,1169,2,waiting,1
13,17,1126.9,562.1,658,1206,1864,3,dotOff,1
13,18,942.8,553,1445,-31,1414,1,waiting,1
13,18,1114,560.4,766,1449,2215,2,dotOff,1
13,19,956.2,558.6,134,-121,13,1,waiting,1
13,19,937.8,556.6,1214,22,1236,2,waiting,1
13,19,1097.7,562.4,762,1269,2031,3,dotOff,1
13,20,935.1,555.5,1463,-24,1439,1,waiting,1
13,20,1111.6,555.9,811,1471,2282,2,dotOff,1
13,21,931.6,563.1,1580,-94,1486,1,waiting,1
13,21,1085.7,556.5,769,1512,2281,2,dotOff,1
13,22,1003.8,559.9,141,-136,5,1,waiting,1
13,22,940.4,558.2,1494,21,1515,2,waiting,1
13,22,1119.5,555.8,749,1549,2298,3,dotOff,1
13,23,937.4,554.4,1445,-54,1391,1,waiting,1
13,23,1099.6,562.1,697,1418,2115,2,dotOff,1
13,24,943.9,555.8,1519,-4,1515,1,waiting,1
13,24,1093.8,552.6,740,1541,2281,2,dotOff,1
13,25,939.7,555.1,1503,-273,1230,1,waiting,1
13,25,1095.4,560.7,459,1256,1715,2,dotOff,1
13,25,1116.6,552.9,224,1725,1949,3,targOff,1
13,26,937.8,552.4,1673,-172,1501,1,waiting,1
13,26,766.8,559.2,753,1528,2281,2,dotOff,1
13,27,936.3,545.4,1768,-272,1496,1,waiting,1
13,27,753.1,557.8,774,1524,2298,2,dotOff,1
13,28,937.7,558.6,1762,-273,1489,1,waiting,1
13,28,753.5,543.4,779,1518,2297,2,dotOff,1
13,29,931.9,553,1593,-272,1321,1,waiting,1
13,29,1111,557.2,767,1348,2115,2,dotOff,1
13,30,939,559.7,1175,6,1181,1,waiting,1
13,30,764.4,572.4,738,1210,1948,2,dotOff,1
13,31,935.8,553.4,1516,-272,1244,1,waiting,1
13,31,1109.3,549.4,751,1281,2032,2,dotOff,1
13,32,941.5,551.5,1531,-273,1258,1,waiting,1
13,32,1111.4,563,664,1285,1949,2,dotOff,1
13,33,1109.2,564.5,290,-273,17,1,waiting,1
13,33,973.4,553.2,209,41,250,2,waiting,1
13,33,934,553.1,1124,261,1385,3,waiting,1
13,33,759.5,560.1,700,1414,2114,4,dotOff,1
13,34,946.9,562.3,245,-162,83,1,waiting,1
13,34,932.4,554.5,654,261,915,2,waiting,1
13,35,933.1,553.9,1467,-274,1193,1,waiting,1
13,35,1092.3,552.6,156,1226,1382,2,dotOff,1
13,35,1120.1,546.2,552,1396,1948,3,targOff,1
13,36,940.1,545.6,1685,-273,1412,1,waiting,1
13,36,768,555,760,1438,2198,2,dotOff,1
13,37,931.8,563.4,433,-274,159,1,waiting,1
13,37,936.8,551.9,500,332,832,2,waiting,1
13,38,938.9,548.2,1442,-273,1169,1,waiting,1
13,38,767.7,553,747,1201,1948,2,dotOff,1
13,39,936.9,543,1447,-201,1246,1,waiting,1
13,39,1091.1,546.2,158,1279,1437,2,dotOff,1
13,39,1116.3,554.4,582,1449,2031,3,targVis,1
13,40,939.7,548.5,1658,-175,1483,1,waiting,1
13,40,770.9,549.8,773,1508,2281,2,dotOff,1
13,41,936.2,552.1,1284,-32,1252,1,waiting,1
13,41,756.1,557,750,1281,2031,2,dotOff,1
13,42,937.3,549.9,1410,-273,1137,1,waiting,1
13,42,755.2,551.5,702,1163,1865,2,dotOff,1
13,43,934.7,550.3,1532,-271,1261,1,waiting,1
13,43,1092.7,546.2,762,1287,2049,2,dotOff,1
13,44,937.8,548.8,1200,-28,1172,1,waiting,1
13,44,1129.6,545.7,756,1209,1965,2,dotOff,1
13,45,935.3,551.5,1275,-35,1240,1,waiting,1
13,45,1109.9,554.5,766,1265,2031,2,dotOff,1
13,46,930.6,554.7,1202,3,1205,1,waiting,1
13,46,763.3,554.7,717,1231,1948,2,dotOff,1
13,47,941.1,540.6,1578,-273,1305,1,waiting,1
13,47,1100.4,541,157,1333,1490,2,dotOff,1
13,47,1116,539.4,613,1501,2114,3,targVis,1
13,48,941.2,545.7,1222,-9,1213,1,waiting,1
13,48,1106.3,552,703,1245,1948,2,dotOff,1
13,1,928.9,547.5,2328,-179,2149,1,waiting,2
13,2,934.6,547.1,2229,-281,1948,1,waiting,2
13,3,937.4,545.8,2478,-280,2198,1,waiting,2
13,4,935.3,551.8,2269,-54,2215,1,waiting,2
13,5,940.3,548,2396,-282,2114,1,waiting,2
13,6,941.6,548.6,2228,-280,1948,1,waiting,2
13,7,943.1,545.8,2066,-282,1784,1,waiting,2
13,8,939.8,540.9,2145,-281,1864,1,waiting,2
13,9,940.2,549.2,2494,-279,2215,1,waiting,2
13,10,934.9,544.7,2031,-66,1965,1,waiting,2
13,11,945.2,548.6,2329,-280,2049,1,waiting,2
13,12,939.1,549,2412,-281,2131,1,waiting,2
13,13,936.7,550.4,2479,-281,2198,1,waiting,2
13,14,938.6,553.6,2475,-281,2194,1,waiting,2
13,15,939.5,547.8,2479,-281,2198,1,waiting,2
13,16,936.6,550.9,2229,-280,1949,1,waiting,2
13,17,936.7,546.1,1966,-18,1948,1,waiting,2
13,18,935.9,539.1,2013,-64,1949,1,waiting,2
13,19,937.6,547.9,2313,-281,2032,1,waiting,2
13,20,935.2,548.4,2226,-277,1949,1,waiting,2
13,21,935,550.1,2412,-280,2132,1,waiting,2
13,22,941.6,552.8,338,-280,58,1,waiting,2
13,22,932.5,543.2,716,199,915,2,waiting,2
13,23,928.4,550.4,2229,-281,1948,1,waiting,2
13,24,939.1,553.9,2126,-245,1881,1,waiting,2
13,25,936.2,549.9,2090,-58,2032,1,waiting,2
13,26,942.4,553.6,2562,-281,2281,1,waiting,2
13,27,940.9,555.8,2496,-280,2216,1,waiting,2
13,28,946.1,556.4,2244,-279,1965,1,waiting,2
13,29,935.1,555.4,1841,-43,1798,1,waiting,2
13,30,934.8,541,2312,-280,2032,1,waiting,2
13,31,936.3,553.6,2090,-58,2032,1,waiting,2
13,32,931.5,555.3,2580,-282,2298,1,waiting,2
13,33,940.2,549.9,2579,-281,2298,1,waiting,2
13,34,936.4,549.7,2579,-281,2298,1,waiting,2
13,35,935.3,550.6,2328,-280,2048,1,waiting,2
13,36,928.2,555.3,285,-280,5,1,waiting,2
13,36,936.8,546.4,1859,23,1882,2,waiting,2
13,37,942.8,553.2,2496,-281,2215,1,waiting,2
13,38,939.5,556.3,2255,-140,2115,1,waiting,2
13,39,937.4,547.2,2411,-280,2131,1,waiting,2
13,40,938.9,552.1,2327,-279,2048,1,waiting,2
13,41,950.6,547.6,319,-281,38,1,waiting,2
13,41,935.2,547.8,1081,167,1248,2,waiting,2
13,42,930.4,549.8,2329,-281,2048,1,waiting,2
13,43,937.3,547.3,2477,-280,2197,1,waiting,2
13,44,937.2,549,1997,-32,1965,1,waiting,2
13,45,943.9,544.2,2411,-280,2131,1,waiting,2
13,46,945,545.4,2578,-280,2298,1,waiting,2
13,47,936.6,545.8,2334,-285,2049,1,waiting,2
13,48,941.2,549.5,2092,-46,2046,1,waiting,2
