person,trial,x,y,dur,on,off,n,timeInt,block
1,1,951.6,513.7,1401,-281,1120,1,waiting,1
1,1,783.8,514.5,474,1152,1626,2,targOff,1
1,2,960.2,514.6,1290,-269,1021,1,waiting,1
1,2,773.6,516,460,1054,1514,2,targOff,1
1,3,947.6,511.9,1190,-273,917,1,waiting,1
1,3,1084.6,505.8,189,941,1130,2,waiting,1
1,3,1124.3,512.2,635,1146,1781,3,dotOff,1
1,4,951.9,520.1,1342,-16,1326,1,waiting,1
1,4,1128.2,514.8,491,1357,1848,2,targOff,1
1,5,958.7,523.1,1144,-45,1099,1,waiting,1
1,5,1140.7,520.9,555,1126,1681,2,targVis,1
1,6,962.2,499.3,196,-120,76,1,waiting,1
1,6,951.8,519.5,1128,84,1212,2,waiting,1
1,6,1139.1,513.8,475,1239,1714,3,targOff,1
1,7,953,504.9,152,-93,59,1,waiting,1
1,7,944.6,518.4,861,67,928,2,waiting,1
1,7,1139.8,514.1,454,960,1414,3,targOff,1
1,8,953.3,518.2,1197,-276,921,1,waiting,1
1,8,1131.3,513.7,166,948,1114,2,waiting,1
1,9,951.3,522.3,1662,-280,1382,1,waiting,1
1,9,793.2,519.9,441,1407,1848,2,targOff,1
1,10,951.7,510.7,1512,-280,1232,1,waiting,1
1,10,772.4,514.5,469,1261,1730,2,targOff,1
1,11,941.9,515,1621,-273,1348,1,waiting,1
1,11,778.3,519.8,490,1375,1865,2,targOff,1
1,12,947.5,521.9,1428,-283,1145,1,waiting,1
1,12,1098.5,524.7,67,1171,1238,2,targVis,1
1,12,1123.9,517.4,483,1247,1730,3,targOff,1
1,13,955.5,516.2,1271,-284,987,1,waiting,1
1,13,1153.2,523.1,459,1022,1481,2,targOff,1
1,14,956.3,518.8,1036,-36,1000,1,waiting,1
1,14,780.4,519.2,470,1027,1497,2,targOff,1
1,15,950.4,525.2,925,-39,886,1,waiting,1
1,15,1082.1,516.8,196,910,1106,2,waiting,1
1,15,1134.6,520.4,527,1121,1648,3,targVis,1
1,16,957,518.8,1199,-238,961,1,waiting,1
1,16,780.3,513.9,424,990,1414,2,targOff,1
1,17,940.1,528.7,1384,-182,1202,1,waiting,1
1,17,1118.2,529,602,1229,1831,2,dotOff,1
1,18,953,517,1293,-282,1011,1,waiting,1
1,18,784.4,513.4,441,1040,1481,2,targOff,1
1,19,952.8,522,1172,-273,899,1,waiting,1
1,19,767.8,518.9,283,931,1214,2,waiting,1
1,20,959.4,522.6,1360,-241,1119,1,waiting,1
1,20,789.1,514.4,469,1145,1614,2,targOff,1
1,21,950.6,525.1,1456,-89,1367,1,waiting,1
1,21,1135,513.7,496,1401,1897,2,targOff,1
1,22,948.7,527.2,1634,-283,1351,1,waiting,1
1,22,1119.7,522.4,502,1378,1880,2,targOff,1
1,23,934.9,526.9,1395,-277,1118,1,waiting,1
1,23,768.2,522,454,1144,1598,2,targOff,1
1,24,955.1,525.3,1343,-277,1066,1,waiting,1
1,24,1136.4,517.8,462,1102,1564,2,targOff,1
1,25,949.7,525.8,1234,-277,957,1,waiting,1
1,25,1127.2,515.7,541,989,1530,2,targVis,1
1,26,952.1,520.9,1516,-281,1235,1,waiting,1
1,26,1111.3,525.6,585,1262,1847,2,dotOff,1
1,27,950.7,518.5,1376,-285,1091,1,waiting,1
1,27,1126.2,528.4,442,1123,1565,2,targOff,1
1,28,953,519.6,1300,-274,1026,1,waiting,1
1,28,1124.9,518.5,438,1060,1498,2,targOff,1
1,29,953.2,524.7,1307,-40,1267,1,waiting,1
1,29,770,517.8,465,1299,1764,2,targOff,1
1,30,965,505.1,334,-286,48,1,waiting,1
1,30,951.6,512.6,1135,56,1191,2,waiting,1
1,30,1111,524.4,611,1219,1830,3,dotOff,1
1,31,951.6,522.1,1209,5,1214,1,waiting,1
1,31,1128.1,526.4,457,1241,1698,2,targOff,1
1,32,952.7,518.6,1261,-51,1210,1,waiting,1
1,32,777,527.8,473,1241,1714,2,targOff,1
1,33,951.3,521.4,1057,-60,997,1,waiting,1
1,33,804.9,513.7,442,1022,1464,2,targOff,1
1,34,951.3,518.9,1091,-49,1042,1,waiting,1
1,34,1122,519,612,1069,1681,2,dotOff,1
1,35,955.9,519.4,1398,-271,1127,1,waiting,1
1,35,1125.8,512.2,494,1154,1648,2,targOff,1
1,36,951.1,518.4,1228,-273,955,1,waiting,1
1,36,1090.5,516.7,169,981,1150,2,dotOff,1
1,36,1124.4,512.2,402,1162,1564,3,targOff,1
1,37,956.8,510.7,1301,-281,1020,1,waiting,1
1,37,786.6,517.6,659,1047,1706,2,waiting,1
1,38,959.9,513.3,1514,-287,1227,1,waiting,1
1,38,1127.4,517.1,455,1259,1714,2,targOff,1
1,39,954.4,515.9,1314,-286,1028,1,waiting,1
1,39,784.6,507.7,460,1054,1514,2,targOff,1
1,40,949.5,514.6,1282,-275,1007,1,waiting,1
1,40,1124.8,516.7,647,1033,1680,2,dotOff,1
1,1,929.3,524.5,136,-19,117,1,waiting,2
1,1,950.2,519.2,1568,129,1697,2,waiting,2
1,2,953.5,525.6,1864,-284,1580,1,waiting,2
1,3,950.3,517.6,1703,-56,1647,1,waiting,2
1,4,961.9,518.6,1900,-19,1881,1,waiting,2
1,5,965.8,510.4,1986,-272,1714,1,waiting,2
1,6,958.9,515.7,2196,-286,1910,1,waiting,2
1,7,953,518.4,1906,-176,1730,1,waiting,2
1,8,958.4,515.5,1738,-291,1447,1,waiting,2
1,9,964.1,518.3,2024,-280,1744,1,waiting,2
1,10,952.9,519.1,1576,-12,1564,1,waiting,2
1,11,954.2,514.3,1478,-14,1464,1,waiting,2
1,12,965.6,524.6,1911,-30,1881,1,waiting,2
1,13,952.2,523.8,1565,-69,1496,1,waiting,2
1,14,961.6,516.2,1439,-9,1430,1,waiting,2
1,15,949.3,517.7,1492,-46,1446,1,waiting,2
1,16,960.5,517.1,1544,-30,1514,1,waiting,2
1,17,953.5,523.3,1763,-282,1481,1,waiting,2
1,18,953.5,516.5,1928,-281,1647,1,waiting,2
1,19,959.5,521.2,1908,-277,1631,1,waiting,2
1,20,959.4,519,1903,-23,1880,1,waiting,2
1,21,957,511.1,1836,-39,1797,1,waiting,2
1,22,946.8,524,1665,-68,1597,1,waiting,2
1,23,950.8,517.6,1567,-53,1514,1,waiting,2
1,24,955.4,526.2,1581,-17,1564,1,waiting,2
1,25,954.4,525.7,1955,-270,1685,1,waiting,2
1,26,952.9,515.7,1952,-272,1680,1,waiting,2
1,27,954.5,516.9,2039,-275,1764,1,waiting,2
1,28,956.5,516.3,2094,-280,1814,1,waiting,2
1,29,950.4,519.2,208,-37,171,1,waiting,2
1,29,947.8,521,1661,187,1848,2,waiting,2
1,30,944.4,525.1,1553,-39,1514,1,waiting,2
1,31,958.9,515.4,1600,-36,1564,1,waiting,2
1,32,952.9,516.7,1649,-52,1597,1,waiting,2
1,33,922.5,525.8,133,-133,0,1,waiting,2
1,33,952.5,518.5,1483,15,1498,2,waiting,2
1,34,955.9,511.9,1995,-234,1761,1,waiting,2
1,35,952.2,528.5,1476,-45,1431,1,waiting,2
1,36,956.8,515.7,1658,-10,1648,1,waiting,2
1,37,954,529.3,1894,-33,1861,1,waiting,2
1,38,949.7,522.2,1651,-4,1647,1,waiting,2
1,39,953.7,527.2,1713,-282,1431,1,waiting,2
1,40,959,524.1,2069,-222,1847,1,waiting,2
2,1,979.7,551.8,506,-250,256,1,waiting,1
2,1,873.9,544.4,139,278,417,2,waiting,1
2,1,801.8,543.7,189,439,628,3,waiting,1
2,1,979.3,561.5,224,655,879,4,waiting,1
2,2,981.7,552.1,1611,-253,1358,1,waiting,1
2,2,1119.8,546.1,315,1384,1699,2,targOff,1
2,3,972.5,557.2,1634,-40,1594,1,waiting,1
2,3,791.8,546.6,191,1623,1814,2,targOff,1
2,4,965.6,565.2,1956,-36,1920,1,waiting,1
2,4,1145.9,557.2,230,1950,2180,2,targOff,1
2,5,967.6,554.7,1243,-76,1167,1,waiting,1
2,5,798.4,552.8,787,1211,1998,2,dotOff,1
2,6,967.8,554,1554,-261,1293,1,waiting,1
2,6,1158.9,550.2,738,1324,2062,2,dotOff,1
2,7,847.3,543.2,274,-267,7,1,waiting,1
2,7,972.4,554.8,1354,31,1385,2,waiting,1
2,7,1147.8,538.3,683,1415,2098,3,dotOff,1
2,8,967.5,554.2,1353,-262,1091,1,waiting,1
2,8,1147.8,547.4,470,1127,1597,2,targOff,1
2,9,968.5,556.7,1166,-248,918,1,waiting,1
2,9,959.1,557.8,521,927,1448,2,waiting,1
2,9,1128.4,553.2,588,1476,2064,3,dotOff,1
2,10,970.9,560,1597,-260,1337,1,waiting,1
2,10,755.5,575.2,227,1383,1610,2,targOff,1
2,11,1051.9,563.4,168,-160,8,1,waiting,1
2,11,975.2,567.2,1263,28,1291,2,waiting,1
2,11,791.8,563.1,522,1324,1846,3,targVis,1
2,12,979,560.3,1576,-259,1317,1,waiting,1
2,12,815.1,561.5,549,1348,1897,2,dotOff,1
2,13,1007.2,569.6,279,-258,21,1,waiting,1
2,13,969.2,564.3,494,38,532,2,waiting,1
2,13,960.3,567,835,539,1374,3,waiting,1
2,13,783.8,575.4,557,1423,1980,4,dotOff,1
2,14,969.8,559.8,1510,-260,1250,1,waiting,1
2,14,1160.1,557.1,536,1278,1814,2,targVis,1
2,15,973,558.8,1199,-9,1190,1,waiting,1
2,15,799.7,571.1,389,1226,1615,2,dotOff,1
2,15,773.1,561.4,129,1647,1776,3,targOff,1
2,16,964.4,561.6,1216,-248,968,1,waiting,1
2,16,807.7,567.7,504,1010,1514,2,targOff,1
2,17,968.5,559.4,1444,-261,1183,1,waiting,1
2,17,796.4,568.1,454,1226,1680,2,targOff,1
2,18,960.5,566.1,1527,-259,1268,1,waiting,1
2,18,811,564.1,510,1301,1811,2,targOff,1
2,19,946.5,548.3,282,-259,23,1,waiting,1
2,19,969.4,560.3,1395,32,1427,2,waiting,1
2,19,801.3,558.1,473,1458,1931,3,targOff,1
2,20,964.9,559.4,1092,-50,1042,1,waiting,1
2,20,804.6,574.1,423,1073,1496,2,targOff,1
2,21,962.2,559.4,1241,-252,989,1,waiting,1
2,21,801.9,563.7,495,1035,1530,2,targOff,1
2,22,964.7,557.5,1686,-252,1434,1,waiting,1
2,22,1143.3,556.6,502,1462,1964,2,targOff,1
2,23,971.5,557.6,755,-250,505,1,waiting,1
2,23,970.3,561.4,694,522,1216,2,waiting,1
2,23,818.3,568.2,345,1259,1604,3,targOff,1
2,23,790.5,551.9,138,1626,1764,4,targOff,1
2,24,972.8,561.4,1089,-245,844,1,waiting,1
2,24,966,565.1,313,863,1176,2,waiting,1
2,24,1116.7,554.2,377,1204,1581,3,targOff,1
2,25,969.5,561.1,1003,-32,971,1,waiting,1
2,25,797,564.4,491,1006,1497,2,targOff,1
2,26,973.4,562.5,1479,-260,1219,1,waiting,1
2,26,1132.1,568,484,1246,1730,2,targOff,1
2,27,976.2,564.1,1347,-259,1088,1,waiting,1
2,27,790.9,579.9,477,1137,1614,2,targOff,1
2,28,961.2,557.3,327,-106,221,1,waiting,1
2,28,965.9,563.1,855,326,1181,2,waiting,1
2,29,994.2,548.1,261,-221,40,1,waiting,1
2,29,972,558.2,1383,57,1440,2,waiting,1
2,29,782,562.9,458,1490,1948,3,targOff,1
2,30,961.1,561.8,1412,-261,1151,1,waiting,1
2,30,1130.2,554.7,422,1175,1597,2,targOff,1
2,31,966.5,565.5,1263,-251,1012,1,waiting,1
2,31,790.3,569.7,443,1055,1498,2,targOff,1
2,32,966,561.7,1468,-251,1217,1,waiting,1
2,32,788.8,564.9,462,1252,1714,2,targOff,1
2,33,963.8,560.6,1215,-252,963,1,waiting,1
2,33,1149,561,468,996,1464,2,targOff,1
2,34,969.8,561.9,1623,-195,1428,1,waiting,1
2,34,811.3,565,452,1479,1931,2,targOff,1
2,35,1000.6,549.8,159,-131,28,1,waiting,1
2,35,973.7,555.3,1303,47,1350,2,waiting,1
2,35,1145.1,558.1,453,1378,1831,3,targOff,1
2,36,961.3,557,1657,-253,1404,1,waiting,1
2,36,1110.6,550.5,374,1440,1814,2,targOff,1
2,37,977.3,564.9,571,-54,517,1,waiting,1
2,37,963.2,550.4,582,534,1116,2,waiting,1
2,37,1137.1,544.7,407,1140,1547,3,targOff,1
2,38,959.8,561,1113,-100,1013,1,waiting,1
2,38,804.5,561.7,470,1060,1530,2,targOff,1
2,39,970.1,557.7,1390,-268,1122,1,waiting,1
2,39,796,556,399,1165,1564,2,targOff,1
2,40,971.1,556.9,1310,-250,1060,1,waiting,1
2,40,1143.9,547.1,440,1089,1529,2,targOff,1
2,1,895.1,550.6,204,18,222,1,waiting,2
2,1,952.3,570.8,1461,236,1697,2,waiting,2
2,2,943.9,569.5,1806,-259,1547,1,waiting,2
2,3,937.4,565.4,2054,-259,1795,1,waiting,2
2,4,939.1,569,1722,-260,1462,1,waiting,2
2,5,950,562.5,2189,-259,1930,1,waiting,2
2,6,953.2,557,1753,-259,1494,1,waiting,2
2,7,944.7,561.7,1911,-264,1647,1,waiting,2
2,8,937.6,552.8,1042,-258,784,1,waiting,2
2,8,935,555.7,971,791,1762,2,waiting,2
2,9,942.4,564.4,1964,-250,1714,1,waiting,2
2,10,937.6,566.6,1853,-264,1589,1,waiting,2
2,11,939.3,568.9,2040,-259,1781,1,waiting,2
2,12,944.7,571.8,2006,-258,1748,1,waiting,2
2,13,945.3,563.7,2135,-255,1880,1,waiting,2
2,14,941.1,566.2,1821,-261,1560,1,waiting,2
2,15,943.8,560.3,2015,-267,1748,1,waiting,2
2,16,938.6,568.9,1726,-29,1697,1,waiting,2
2,17,936,572.5,1866,-252,1614,1,waiting,2
2,18,934.3,573.6,1926,-262,1664,1,waiting,2
2,19,943.5,567.9,2037,-260,1777,1,waiting,2
2,20,938.8,568.6,1980,-266,1714,1,waiting,2
2,21,942.5,564.8,2108,-261,1847,1,waiting,2
2,22,939.7,565.9,1809,-262,1547,1,waiting,2
2,23,937,566.1,1978,-247,1731,1,waiting,2
2,24,942.7,574.6,2107,-259,1848,1,waiting,2
2,25,944.7,561.9,1795,-248,1547,1,waiting,2
2,26,948.4,561.1,1790,-260,1530,1,waiting,2
2,27,944.5,562,2023,-259,1764,1,waiting,2
2,28,947,570.9,1893,-246,1647,1,waiting,2
2,29,940.8,568.1,2038,-259,1779,1,waiting,2
2,30,945.3,571.4,1989,-259,1730,1,waiting,2
2,31,933.7,572,785,-258,527,1,waiting,2
2,31,931.9,568.2,303,643,946,2,waiting,2
2,32,970.4,562,279,-252,27,1,waiting,2
2,32,946.3,561.4,1495,36,1531,2,waiting,2
2,33,939.5,565.5,1656,-79,1577,1,waiting,2
2,34,930.5,557.5,530,-259,271,1,waiting,2
2,34,974,561.2,130,282,412,2,waiting,2
2,34,941.1,563.5,1179,431,1610,3,waiting,2
2,35,937.4,569.5,1950,-253,1697,1,waiting,2
2,36,943.2,566.3,2157,-260,1897,1,waiting,2
2,37,940.5,567.6,2037,-259,1778,1,waiting,2
2,38,929.6,573.5,549,-158,391,1,waiting,2
2,38,936.3,586,527,501,1028,2,waiting,2
2,39,943.9,571.5,1919,12,1931,1,waiting,2
2,40,941.1,560.2,1712,-248,1464,1,waiting,2
2,1,936.2,564.7,1620,-254,1366,1,waiting,3
2,1,1104.9,567.1,463,1402,1865,2,targOff,3
2,2,972.6,566.4,264,-260,4,1,waiting,3
2,2,943.8,559.4,1057,22,1079,2,waiting,3
2,2,1116,556.7,407,1107,1514,3,targOff,3
2,3,943.5,561.4,1276,-26,1250,1,waiting,3
2,3,1132.3,567.9,538,1277,1815,2,targVis,3
2,4,938.6,555.4,1379,-260,1119,1,waiting,3
2,4,1113.9,550.8,292,1154,1446,2,targOff,3
2,5,942.3,559.8,1490,-253,1237,1,waiting,3
2,5,766.8,576,496,1284,1780,2,targOff,3
2,6,942.3,551,1400,-259,1141,1,waiting,3
2,6,762.4,570.4,440,1187,1627,2,targOff,3
2,7,940.1,554,1235,-260,975,1,waiting,3
2,7,760.7,566.9,441,1006,1447,2,targOff,3
2,8,936.3,560.6,1322,-257,1065,1,waiting,3
2,8,1118.5,556.2,471,1093,1564,2,targOff,3
2,9,935.6,559.5,1488,-252,1236,1,waiting,3
2,9,1113.4,574.2,498,1266,1764,2,targOff,3
2,10,939.3,553.9,1442,0,1442,1,waiting,3
2,10,777.6,573.7,440,1491,1931,2,targOff,3
2,11,935.7,559.1,732,-252,480,1,waiting,3
2,11,942.7,551.8,641,498,1139,2,waiting,3
2,11,1133.7,552.6,446,1168,1614,3,targOff,3
2,12,940,548.1,1279,-252,1027,1,waiting,3
2,12,1125.4,559.2,477,1054,1531,2,targOff,3
2,13,943.7,557.9,1237,-261,976,1,waiting,3
2,13,924.5,562.5,356,996,1352,2,waiting,3
2,13,1113.5,565.6,454,1393,1847,3,targOff,3
2,14,943.3,553.9,1271,-248,1023,1,waiting,3
2,14,773.6,566.4,427,1071,1498,2,targOff,3
2,15,970.8,544.4,287,-266,21,1,waiting,3
2,15,945.5,557.9,1380,27,1407,2,waiting,3
2,15,1134.7,555,447,1450,1897,3,targOff,3
2,16,933.7,559.2,1227,-263,964,1,waiting,3
2,16,1113.7,565.2,456,991,1447,2,targOff,3
2,17,947.6,560,1413,-267,1146,1,waiting,3
2,17,1123.5,553.7,442,1172,1614,2,targOff,3
2,18,946.7,558.4,1368,-267,1101,1,waiting,3
2,18,1121.4,560.7,487,1127,1614,2,targOff,3
2,19,942.6,556.8,1581,-265,1316,1,waiting,3
2,19,767.4,573.6,434,1364,1798,2,targOff,3
2,20,948.3,552.9,1357,-250,1107,1,waiting,3
2,20,1126.3,561.4,466,1131,1597,2,targOff,3
2,21,943.2,553.5,1634,-253,1381,1,waiting,3
2,21,790.3,576,453,1427,1880,2,targOff,3
2,22,949.3,557.2,1411,-4,1407,1,waiting,3
2,22,1123.2,560.1,429,1435,1864,2,targOff,3
2,23,936.9,558.3,314,-60,254,1,waiting,3
2,23,943.8,555.2,914,271,1185,2,waiting,3
2,23,1143.4,547.8,237,1227,1464,3,targOff,3
2,24,948.1,540.6,279,-250,29,1,waiting,3
2,24,941.2,560.8,1246,45,1291,2,waiting,3
2,24,1128.9,569.5,445,1319,1764,3,targOff,3
2,25,933,575.4,1349,-248,1101,1,waiting,3
2,25,1104.2,574.6,787,1127,1914,2,waiting,3
2,26,953.6,562.5,214,14,228,1,waiting,3
2,26,939.8,564.4,792,237,1029,2,waiting,3
2,26,773.4,581.3,423,1074,1497,3,targOff,3
2,27,943.7,574.3,575,-261,314,1,waiting,3
2,27,778.6,570.1,431,339,770,2,waiting,3
2,28,945,567.3,1404,4,1408,1,waiting,3
2,28,765.7,579.8,426,1454,1880,2,targOff,3
2,29,954.5,555.1,1486,-247,1239,1,waiting,3
2,29,943.7,569.5,121,1255,1376,2,dotOff,3
2,29,1124.7,566.4,427,1403,1830,3,targOff,3
2,30,940.8,562.5,1244,-260,984,1,waiting,3
2,30,1127,563.3,435,1011,1446,2,targOff,3
2,31,937.3,582.7,1397,-266,1131,1,waiting,3
2,32,951,565.4,305,-253,52,1,waiting,3
2,32,944.3,567.1,1315,69,1384,2,waiting,3
2,32,766.1,574.1,466,1415,1881,3,targOff,3
2,33,939.5,569.1,1410,-259,1151,1,waiting,3
2,33,764.5,572.5,434,1197,1631,2,targOff,3
2,34,939.7,571.3,1508,-259,1249,1,waiting,3
2,34,784.5,580.7,329,1281,1610,2,targOff,3
2,34,758.8,571.7,88,1639,1727,3,targOff,3
2,35,938.3,573.7,994,14,1008,1,waiting,3
2,35,774.5,592.2,413,1051,1464,2,targOff,3
2,36,938.1,574.2,1675,-252,1423,1,waiting,3
2,36,774.8,579.3,460,1471,1931,2,targOff,3
2,37,941.6,570.9,1417,-246,1171,1,waiting,3
2,37,768.9,576.3,445,1203,1648,2,targOff,3
2,38,930.5,571.1,1670,-265,1405,1,waiting,3
2,38,766.9,570.2,445,1452,1897,2,targOff,3
2,39,940.1,564,1258,-266,992,1,waiting,3
2,39,1101.1,567.5,308,1017,1325,2,targOff,3
2,39,1122.2,561.3,104,1343,1447,3,targOff,3
2,40,937.8,564.8,1587,-260,1327,1,waiting,3
2,40,769.7,573,455,1375,1830,2,targOff,3
2,1,849.8,571.6,180,-117,63,1,waiting,4
2,1,933.5,566.5,165,89,254,2,waiting,4
2,1,965.1,562.3,122,271,393,3,waiting,4
2,1,945.6,560.5,703,402,1105,4,waiting,4
2,1,935.7,565.5,435,1112,1547,5,targOff,4
2,2,950.8,574.6,1581,-33,1548,1,waiting,4
2,2,757.6,567.7,216,1598,1814,2,targOff,4
2,3,976.8,562.2,282,-257,25,1,waiting,4
2,3,945.5,565.1,1784,47,1831,2,waiting,4
2,4,944.4,562.7,1848,-251,1597,1,waiting,4
2,5,946,549.3,1846,-98,1748,1,waiting,4
2,6,945.4,548,1949,-252,1697,1,waiting,4
2,7,938.9,549.3,1807,-260,1547,1,waiting,4
2,8,949.1,553.8,2038,-260,1778,1,waiting,4
2,9,936.5,568.4,2056,-259,1797,1,waiting,4
2,10,947.5,558,2172,-259,1913,1,waiting,4
2,11,951.4,564.3,2130,-266,1864,1,waiting,4
2,12,948.6,573.7,154,-147,7,1,waiting,4
2,12,942.1,571.5,1791,23,1814,2,waiting,4
2,13,939.4,568.8,1727,-259,1468,1,waiting,4
2,13,777.1,574.1,211,1515,1726,2,targOff,4
2,14,945.3,568.2,1387,19,1406,1,waiting,4
2,14,930.1,565.5,104,1427,1531,2,targOff,4
2,15,947.4,564.7,1908,-261,1647,1,waiting,4
2,16,939.3,575.2,2003,-139,1864,1,waiting,4
2,17,939.4,569.8,1727,-263,1464,1,waiting,4
2,18,940.3,576.4,508,-258,250,1,waiting,4
2,18,947.3,571.8,1038,269,1307,2,waiting,4
2,18,930,570.4,157,1324,1481,3,targOff,4
2,19,942.2,571.5,2042,-261,1781,1,waiting,4
2,20,943.9,575.4,1932,-252,1680,1,waiting,4
2,21,945.9,563.5,1944,-262,1682,1,waiting,4
2,21,928.1,571.7,189,1708,1897,2,targOff,4
2,22,948.1,564.9,1824,-260,1564,1,waiting,4
2,23,946.7,564.6,1908,-261,1647,1,waiting,4
2,24,932.3,570.3,1723,-260,1463,1,waiting,4
2,25,945.7,570.2,2140,-260,1880,1,waiting,4
2,26,942.5,573,1837,-260,1577,1,waiting,4
2,26,940.6,572.2,195,1585,1780,2,targOff,4
2,27,944.5,573.9,1704,-261,1443,1,waiting,4
2,28,936.2,573.1,1689,-260,1429,1,waiting,4
2,29,947.8,576.6,2048,-267,1781,1,waiting,4
2,30,947,571.4,1870,-263,1607,1,waiting,4
2,30,932.5,573.2,187,1627,1814,2,targOff,4
2,31,937.9,574.5,1943,-261,1682,1,waiting,4
2,31,916.3,565.8,213,1701,1914,2,targOff,4
2,32,939.5,565.3,1757,-260,1497,1,waiting,4
2,33,940.6,564,1925,-261,1664,1,waiting,4
2,34,942.4,569.4,1790,-260,1530,1,waiting,4
2,35,949.9,576,2119,-259,1860,1,waiting,4
2,36,932.8,581.2,1183,-253,930,1,waiting,4
2,37,950.5,570.2,1373,-6,1367,1,waiting,4
2,37,944.5,574.5,457,1386,1843,2,targOff,4
2,38,936.8,576.3,1932,-251,1681,1,waiting,4
2,39,944.8,578.6,2090,-260,1830,1,waiting,4
2,40,946.7,588.4,494,-266,228,1,waiting,4
2,40,941,575.1,1412,235,1647,2,waiting,4
2,1,971.8,542.3,123,-32,91,1,waiting,5
2,1,964.2,570,1072,119,1191,2,waiting,5
2,1,774.5,565.9,454,1226,1680,3,targOff,5
2,2,957.9,569.3,1689,-261,1428,1,waiting,5
2,2,775.4,574.3,458,1472,1930,2,targOff,5
2,3,959.5,561.9,1222,-46,1176,1,waiting,5
2,3,1134.1,566.3,440,1205,1645,2,targOff,5
2,4,960,569.2,1256,-37,1219,1,waiting,5
2,4,1134.2,574.8,417,1247,1664,2,targOff,5
2,5,955.5,563.5,1299,-251,1048,1,waiting,5
2,5,780.2,568.7,448,1083,1531,2,targOff,5
2,6,955.6,565,1610,-264,1346,1,waiting,5
2,6,1123.9,564.5,457,1373,1830,2,targOff,5
2,7,953.6,560.7,1445,-255,1190,1,waiting,5
2,7,1134.8,569.6,431,1216,1647,2,targOff,5
2,8,961,566.6,1649,-260,1389,1,waiting,5
2,8,787.2,577.7,460,1433,1893,2,targOff,5
2,9,959.3,563.1,1226,-264,962,1,waiting,5
2,9,1137.3,557.5,439,992,1431,2,targOff,5
2,10,960.3,569.9,1647,-260,1387,1,waiting,5
2,10,1136.8,565.3,448,1413,1861,2,targOff,5
2,11,954.9,570.6,1570,-260,1310,1,waiting,5
2,11,1129.5,561.6,458,1339,1797,2,targOff,5
2,12,954.9,575.6,1538,-260,1278,1,waiting,5
2,12,1136.7,565.6,455,1308,1763,2,targOff,5
2,13,956.3,571.9,1568,-259,1309,1,waiting,5
2,13,775.6,568.1,472,1357,1829,2,targOff,5
2,14,955.1,572.3,1309,-260,1049,1,waiting,5
2,14,783.2,570.5,131,1080,1211,2,targOff,5
2,14,758.5,568.8,68,1392,1460,3,targOff,5
2,15,950.3,574.9,1710,-259,1451,1,waiting,5
2,15,1106.1,579.8,277,1478,1755,2,targOff,5
2,15,1150.7,571.5,97,1779,1876,3,targOff,5
2,16,948.3,574.6,1446,-262,1184,1,waiting,5
2,16,1136.8,579.1,414,1217,1631,2,targOff,5
2,17,953.6,573.2,1638,-260,1378,1,waiting,5
2,17,1138.8,577.3,456,1403,1859,2,targOff,5
2,18,957.2,569.2,1607,-261,1346,1,waiting,5
2,18,770.8,577.6,440,1391,1831,2,targOff,5
2,19,949,578.8,1561,-249,1312,1,waiting,5
2,19,764.6,585.8,436,1345,1781,2,targOff,5
2,20,948.7,575.4,1427,-51,1376,1,waiting,5
2,20,1139.1,570.4,440,1408,1848,2,targOff,5
2,21,950.7,575.3,1676,-250,1426,1,waiting,5
2,21,1132,576.2,156,1454,1610,2,targOff,5
2,21,1152.2,560.8,102,1748,1850,3,targOff,5
2,22,952.6,573.3,1695,-255,1440,1,waiting,5
2,22,782.3,583.4,458,1473,1931,2,targOff,5
2,23,951.6,577.3,1495,-260,1235,1,waiting,5
2,23,781,582.3,412,1283,1695,2,targOff,5
2,24,947.1,577.7,1875,-260,1615,1,waiting,5
2,24,796.8,571.8,181,1665,1846,2,targOff,5
2,25,953.3,576.4,1451,-261,1190,1,waiting,5
2,25,1132,586.8,429,1217,1646,2,targOff,5
2,26,950.1,575,1630,-261,1369,1,waiting,5
2,26,785.7,582.4,461,1403,1864,2,targOff,5
2,27,954,566.9,1482,-252,1230,1,waiting,5
2,27,1119.1,573.7,408,1257,1665,2,targOff,5
2,28,956.9,574.5,1475,-262,1213,1,waiting,5
2,28,1125.3,572,412,1252,1664,2,targOff,5
2,29,954,573.1,1383,-264,1119,1,waiting,5
2,29,780.5,588.4,455,1159,1614,2,targOff,5
2,30,956.3,574,1249,-253,996,1,waiting,5
2,30,1132.7,566.1,458,1023,1481,2,targOff,5
2,31,952.4,577.1,1609,-267,1342,1,waiting,5
2,31,769.9,588.1,240,1373,1613,2,targOff,5
2,32,949.5,573,1433,-260,1173,1,waiting,5
2,32,784.6,600.9,472,1222,1694,2,targOff,5
2,33,948.5,571.6,1475,-254,1221,1,waiting,5
2,33,1119.1,574.9,418,1246,1664,2,targOff,5
2,34,954.3,578.8,1536,-249,1287,1,waiting,5
2,34,1123.5,573.8,468,1313,1781,2,targOff,5
2,35,964.6,567.3,671,-253,418,1,waiting,5
2,35,947.7,570.9,780,433,1213,2,waiting,5
2,35,785.1,583.4,478,1253,1731,3,targOff,5
2,36,952.2,576.4,1648,-260,1388,1,waiting,5
2,36,1117.1,569.6,463,1414,1877,2,targOff,5
2,37,952.8,578.6,1101,-37,1064,1,waiting,5
2,37,779.3,582.4,466,1099,1565,2,targOff,5
2,38,956.1,569.5,1250,-259,991,1,waiting,5
2,38,1127,578.3,424,1024,1448,2,targOff,5
2,39,956.7,579.7,1314,-260,1054,1,waiting,5
2,39,1109.2,572.8,432,1078,1510,2,targOff,5
2,40,954.9,569.4,350,-261,89,1,waiting,5
2,40,949.1,574.1,1164,105,1269,2,waiting,5
2,40,1130.6,580.3,447,1300,1747,3,targOff,5
2,1,1002.1,566.8,289,-253,36,1,waiting,6
2,1,951.4,566.7,1671,60,1731,2,waiting,6
2,2,950.4,573.8,2097,-261,1836,1,waiting,6
2,3,946.2,576.5,1868,-254,1614,1,waiting,6
2,4,949.7,574.4,1783,-19,1764,1,waiting,6
2,5,960.3,571.6,235,-23,212,1,waiting,6
2,5,956,568.2,1321,227,1548,2,waiting,6
2,6,953.7,572.6,1971,-260,1711,1,waiting,6
2,7,948.6,570.6,1560,-32,1528,1,waiting,6
2,8,948.4,577,2026,-262,1764,1,waiting,6
2,9,987.8,575.8,284,-260,24,1,waiting,6
2,9,954.4,573.9,1618,41,1659,2,waiting,6
2,9,768.1,585.8,203,1711,1914,3,targOff,6
2,10,1001.6,566.3,236,-229,7,1,waiting,6
2,10,946.5,571.4,1630,31,1661,2,waiting,6
2,10,937.3,575.4,232,1682,1914,3,targOff,6
2,11,950,572.3,1886,-256,1630,1,waiting,6
2,12,947.9,575.9,1868,-254,1614,1,waiting,6
2,13,948.1,581,1500,-252,1248,1,waiting,6
2,14,946.1,577.8,1760,21,1781,1,waiting,6
2,15,957.2,574.4,282,-259,23,1,waiting,6
2,15,955.2,572,1386,42,1428,2,waiting,6
2,16,960.6,575.2,1920,-260,1660,1,waiting,6
2,17,955.4,575,1956,-260,1696,1,waiting,6
2,18,952.2,579.4,1262,-248,1014,1,waiting,6
2,19,966.6,579.4,160,-53,107,1,waiting,6
2,19,957,568,706,126,832,2,waiting,6
2,19,956.4,587.2,798,850,1648,3,waiting,6
2,20,962.2,573.8,275,-257,18,1,waiting,6
2,20,959.1,571.7,1737,25,1762,2,waiting,6
2,21,949,570.8,2016,-252,1764,1,waiting,6
2,22,951.5,566,1959,-28,1931,1,waiting,6
2,23,956.6,569,1856,-258,1598,1,waiting,6
2,23,939.3,562.9,225,1619,1844,2,targOff,6
2,24,953.9,567.8,1619,-252,1367,1,waiting,6
2,24,944.7,564.9,113,1384,1497,2,targOff,6
2,25,956.9,573.8,1715,-34,1681,1,waiting,6
2,26,1002.9,573.3,123,-110,13,1,waiting,6
2,26,957.2,574.8,1528,37,1565,2,waiting,6
2,27,950.5,580.1,2029,-249,1780,1,waiting,6
2,28,960.9,579,1179,-249,930,1,waiting,6
2,29,1010.2,578.3,256,-253,3,1,waiting,6
2,29,954,572.4,1405,26,1431,2,waiting,6
2,30,954.7,571.6,1970,-248,1722,1,waiting,6
2,30,944.8,567.4,116,1731,1847,2,targOff,6
2,31,956.2,568.3,1881,-267,1614,1,waiting,6
2,32,966,582.3,55,-41,14,1,waiting,6
2,32,954.1,565.2,1464,33,1497,2,waiting,6
2,33,951.1,579,1543,-46,1497,1,waiting,6
2,34,962,566.4,1648,-200,1448,1,waiting,6
2,35,959,577.6,2039,-260,1779,1,waiting,6
2,36,949.2,573,1810,-13,1797,1,waiting,6
2,37,954.1,579.2,465,-77,388,1,waiting,6
2,37,950.3,570.8,1220,402,1622,2,waiting,6
2,37,963.7,561.9,119,1643,1762,3,targOff,6
2,38,953.8,567.7,1941,-260,1681,1,waiting,6
2,39,955.3,579.9,2062,-253,1809,1,waiting,6
2,39,971.2,573.5,87,1827,1914,2,targOff,6
2,40,956.5,563.5,1852,-259,1593,1,waiting,6
2,1,1107.2,581.1,286,-257,29,1,waiting,7
2,1,926.6,569.7,252,75,327,2,waiting,7
2,1,944.7,578.9,791,334,1125,3,waiting,7
2,1,774.2,580.3,423,1174,1597,4,targOff,7
2,2,941.4,574.3,1559,-260,1299,1,waiting,7
2,2,1132.5,569.8,454,1324,1778,2,targOff,7
2,3,939.6,573.3,1137,-22,1115,1,waiting,7
2,3,1110.2,580.3,406,1141,1547,2,targOff,7
2,4,975.4,583.2,264,-253,11,1,waiting,7
2,4,952.8,570.6,1082,21,1103,2,waiting,7
2,4,772,575.4,427,1137,1564,3,targOff,7
2,5,955.2,570,1298,-252,1046,1,waiting,7
2,5,1119.4,570.8,422,1075,1497,2,targOff,7
2,6,949.9,573.8,1482,-250,1232,1,waiting,7
2,6,773.8,582,468,1278,1746,2,targOff,7
2,7,951.7,575.9,1074,-12,1062,1,waiting,7
2,7,784.8,583.2,469,1096,1565,2,targOff,7
2,8,952.9,568.6,1107,-138,969,1,waiting,7
2,8,785.6,589.4,463,1001,1464,2,targOff,7
2,9,943.4,576.8,2036,-252,1784,1,waiting,7
2,9,792.2,576.1,82,1832,1914,2,targOff,7
2,10,957,579.1,1414,-266,1148,1,waiting,7
2,10,793.2,587.8,451,1180,1631,2,targOff,7
2,11,957.8,577.8,614,-261,353,1,waiting,7
2,11,958.4,574.9,1182,366,1548,2,waiting,7
2,11,765.5,586.1,337,1593,1930,3,targOff,7
2,12,949.6,576,1280,-251,1029,1,waiting,7
2,12,1119,585.3,426,1055,1481,2,targOff,7
2,13,954.5,585.4,1090,-43,1047,1,waiting,7
2,14,923,575.8,264,-259,5,1,waiting,7
2,14,949.7,572.9,1288,23,1311,2,waiting,7
2,14,805.8,581.3,337,1359,1696,3,targOff,7
2,14,748.6,590,81,1716,1797,4,targOff,7
2,15,974.8,566.8,280,-259,21,1,waiting,7
2,15,948.1,564.7,1235,38,1273,2,waiting,7
2,15,768.8,587,491,1321,1812,3,targOff,7
2,16,950.4,574.8,1536,-252,1284,1,waiting,7
2,16,794.5,583.1,352,1333,1685,2,targOff,7
2,16,760.3,582.7,88,1710,1798,3,targOff,7
2,17,949.2,578.7,998,16,1014,1,waiting,7
2,17,767.5,578,448,1063,1511,2,targOff,7
2,18,956.4,573.4,1483,-259,1224,1,waiting,7
2,18,784.1,595.4,662,1268,1930,2,dotOff,7
2,19,884.8,563.5,129,-110,19,1,waiting,7
2,19,949.8,575.3,1015,46,1061,2,waiting,7
2,19,770.2,586.4,422,1109,1531,3,targOff,7
2,20,953.9,580.6,1219,-259,960,1,waiting,7
2,21,986.5,562.9,269,-258,11,1,waiting,7
2,21,947.2,575.5,1149,35,1184,2,waiting,7
2,21,1121.6,559.3,305,1209,1514,3,targOff,7
2,22,951.8,571.4,1551,-261,1290,1,waiting,7
2,22,1114.5,568.9,479,1318,1797,2,targOff,7
2,23,955.6,578.9,1562,-260,1302,1,waiting,7
2,23,1127.6,579.7,451,1328,1779,2,targOff,7
2,24,956.8,565.8,1256,-24,1232,1,waiting,7
2,24,1116.3,581.1,421,1260,1681,2,targOff,7
2,25,955.6,567.8,1689,-250,1439,1,waiting,7
2,25,1112,571.6,466,1463,1929,2,targOff,7
2,26,955.7,568.1,1278,-258,1020,1,waiting,7
2,26,1129.1,574.3,449,1049,1498,2,targOff,7
2,27,955.2,576,1677,-264,1413,1,waiting,7
2,27,1111.4,572.2,472,1442,1914,2,targOff,7
2,28,953.7,560.3,1442,-47,1395,1,waiting,7
2,28,773,572.8,472,1441,1913,2,targOff,7
2,29,949.6,569.6,1364,-253,1111,1,waiting,7
2,29,1123.7,571.7,442,1138,1580,2,targOff,7
2,30,954.5,566.6,1419,-251,1168,1,waiting,7
2,30,1122,575.7,468,1194,1662,2,targOff,7
2,31,954.9,566.1,1452,-262,1190,1,waiting,7
2,31,1132.3,574.1,482,1216,1698,2,targOff,7
2,32,959.1,574.8,1496,-251,1245,1,waiting,7
2,32,1060.3,582.3,142,1267,1409,2,targOff,7
2,32,1141.5,572.3,164,1433,1597,3,targOff,7
2,33,962.2,580.7,362,-259,103,1,waiting,7
2,33,959.1,564.8,989,123,1112,2,waiting,7
2,33,947.6,574.2,274,1120,1394,3,waiting,7
2,33,1125.6,572.1,439,1424,1863,4,targOff,7
2,34,952.1,563.2,290,-252,38,1,waiting,7
2,34,957.7,567.1,1097,45,1142,2,waiting,7
2,34,778.2,590,452,1178,1630,3,targOff,7
2,35,958.1,562.9,1363,-252,1111,1,waiting,7
2,35,789.6,583.7,275,1158,1433,2,targOff,7
2,35,759.3,571.7,166,1448,1614,3,targOff,7
2,36,980.5,573.5,144,-95,49,1,waiting,7
2,36,957.7,566.5,1275,70,1345,2,waiting,7
2,36,775.2,596.8,468,1396,1864,3,targOff,7
2,37,952.5,582.1,560,-263,297,1,waiting,7
2,37,950.6,571.1,930,304,1234,2,waiting,7
2,37,776.9,580.6,464,1283,1747,3,targOff,7
2,38,944.5,573.2,1214,-30,1184,1,waiting,7
2,38,780.7,587.2,469,1228,1697,2,targOff,7
2,39,953.6,564,1486,-251,1235,1,waiting,7
2,39,1119.3,578,470,1261,1731,2,targOff,7
2,40,959.5,568.9,1537,-170,1367,1,waiting,7
2,40,772.2,588,493,1404,1897,2,targOff,7
2,1,976.2,561.1,254,-220,34,1,waiting,8
2,1,943.8,583.7,1442,55,1497,2,waiting,8
2,2,950.3,571.9,1284,-260,1024,1,waiting,8
2,2,939.7,562.5,650,1031,1681,2,dotOff,8
2,3,948.5,583.6,1119,-255,864,1,waiting,8
2,4,937.8,575.4,1697,-253,1444,1,waiting,8
2,4,952,569.1,116,1465,1581,2,targOff,8
2,5,948.7,574.2,1875,-247,1628,1,waiting,8
2,5,941.5,578.7,180,1650,1830,2,targOff,8
2,6,944.3,573.3,1786,-254,1532,1,waiting,8
2,7,942.7,580.4,1875,-261,1614,1,waiting,8
2,8,930.2,569.6,121,-111,10,1,waiting,8
2,8,947.4,566.8,699,98,797,2,waiting,8
2,9,977.5,575.3,183,-155,28,1,waiting,8
2,9,947.5,578.7,1401,46,1447,2,waiting,8
2,10,953.3,574.1,1779,18,1797,1,waiting,8
2,11,955.7,575.6,1776,-263,1513,1,waiting,8
2,11,952.2,573.1,231,1533,1764,2,targOff,8
2,12,961.2,570.5,1562,-259,1303,1,waiting,8
2,12,950.5,578.7,236,1312,1548,2,targOff,8
2,13,961.8,569.9,445,-42,403,1,waiting,8
2,13,953.8,577,841,417,1258,2,waiting,8
2,13,965.7,570.5,211,1270,1481,3,targOff,8
2,14,956.6,576,1938,-258,1680,1,waiting,8
2,15,947.6,569.4,1724,-260,1464,1,waiting,8
2,16,956,571.5,2007,-260,1747,1,waiting,8
2,17,953,576.2,2093,-246,1847,1,waiting,8
2,18,952.9,579.4,1968,-141,1827,1,waiting,8
2,19,954.7,570.7,1657,-26,1631,1,waiting,8
2,20,956.2,568.1,1706,-259,1447,1,waiting,8
2,21,950.9,577.7,1835,-254,1581,1,waiting,8
2,22,949.8,571.8,1699,-252,1447,1,waiting,8
2,23,951.9,583.7,1169,-255,914,1,waiting,8
2,24,866.5,574.5,165,-157,8,1,waiting,8
2,24,951.9,570.7,788,34,822,2,waiting,8
2,24,953.6,574.1,945,836,1781,3,waiting,8
2,25,962.6,578.5,363,-260,103,1,waiting,8
2,25,950.9,579.1,1518,110,1628,2,waiting,8
2,26,978.7,585.4,258,-258,0,1,waiting,8
2,26,954.6,578.2,1559,23,1582,2,waiting,8
2,26,964.6,574.8,131,1600,1731,3,targOff,8
2,27,954.5,568.5,1643,4,1647,1,waiting,8
2,28,954.5,573.9,1227,-264,963,1,waiting,8
2,28,943.6,563.9,146,983,1129,2,targOff,8
2,28,960.8,565.7,334,1146,1480,3,targOff,8
2,29,950,568.7,1873,-259,1614,1,waiting,8
2,30,954.4,575,1893,-262,1631,1,waiting,8
2,31,956.7,571,2133,-252,1881,1,waiting,8
2,32,955.9,579.2,1134,-253,881,1,waiting,8
2,33,947,567.1,2045,-132,1913,1,waiting,8
2,34,943.6,580.8,1230,-32,1198,1,waiting,8
2,35,951.4,569.6,1645,-1,1644,1,waiting,8
2,35,943,574.7,106,1658,1764,2,targOff,8
2,36,945.5,579.5,1074,-260,814,1,waiting,8
2,37,952.1,567.2,1766,-185,1581,1,waiting,8
2,38,955.3,574.3,1993,-263,1730,1,waiting,8
2,39,972,569.8,265,-261,4,1,waiting,8
2,39,955,572.5,1566,15,1581,2,waiting,8
2,40,947.1,573.7,1758,-261,1497,1,waiting,8
2,1,1148.8,534.8,126,-114,12,1,waiting,9
2,1,948.6,542.4,962,56,1018,2,waiting,9
2,1,776.6,543.3,400,1063,1463,3,targOff,9
2,2,946,544.5,1494,-251,1243,1,waiting,9
2,2,772.1,544.3,490,1291,1781,2,targOff,9
2,3,944.2,538.5,1407,-261,1146,1,waiting,9
2,3,1117.9,541.8,456,1175,1631,2,targOff,9
2,4,945.4,535.1,1356,-247,1109,1,waiting,9
2,4,766.8,544.1,458,1156,1614,2,targOff,9
2,5,941.3,538.3,1455,-266,1189,1,waiting,9
2,5,771.9,545.3,460,1237,1697,2,targOff,9
2,6,942.3,539.4,1518,-264,1254,1,waiting,9
2,6,785.3,546.7,447,1301,1748,2,targOff,9
2,7,945.7,540.8,1358,-260,1098,1,waiting,9
2,7,773.2,549.9,432,1145,1577,2,targOff,9
2,8,942.3,540.6,1678,-262,1416,1,waiting,9
2,8,1123.4,537,445,1442,1887,2,targOff,9
2,9,944.6,546.8,1814,-264,1550,1,waiting,9
2,9,1112.5,538.2,272,1575,1847,2,targOff,9
2,10,929.4,537.2,297,-267,30,1,waiting,9
2,10,943.6,547.9,1411,38,1449,2,waiting,9
2,10,1120.2,545.2,432,1477,1909,3,targOff,9
2,11,934.1,540.2,1625,-254,1371,1,waiting,9
2,11,785.5,550,447,1417,1864,2,targOff,9
2,12,940.3,544.9,1385,-255,1130,1,waiting,9
2,12,1123.3,537.2,440,1157,1597,2,targOff,9
2,13,937.4,547.2,1670,-248,1422,1,waiting,9
2,13,776.2,551.6,277,1451,1728,2,targOff,9
2,13,746.3,550.2,167,1747,1914,3,targOff,9
2,14,912.9,546.3,284,-262,22,1,waiting,9
2,14,943.5,538.6,1340,41,1381,2,waiting,9
2,14,1117.5,541.1,439,1408,1847,3,targOff,9
2,15,940.4,554.2,1564,-260,1304,1,waiting,9
2,15,769.9,566.1,445,1352,1797,2,targOff,9
2,16,941,547.3,1565,-263,1302,1,waiting,9
2,16,777.1,557.1,424,1357,1781,2,targOff,9
2,17,936.3,552.7,1624,-199,1425,1,waiting,9
2,17,766.9,550.5,426,1455,1881,2,targOff,9
2,18,938.8,554.1,162,-92,70,1,waiting,9
2,18,938.3,550.7,1038,88,1126,2,waiting,9
2,18,1111.5,549.8,427,1152,1579,3,targOff,9
2,19,936.5,541.6,1293,17,1310,1,waiting,9
2,19,1113.2,555.1,444,1337,1781,2,targOff,9
2,20,944.7,547.3,1271,-259,1012,1,waiting,9
2,20,775,556.1,437,1059,1496,2,targOff,9
2,21,944.2,542.7,420,-50,370,1,waiting,9
2,21,938.3,551.5,1049,387,1436,2,waiting,9
2,21,1119.9,543.9,449,1465,1914,3,targOff,9
2,22,942.3,552.1,1372,-254,1118,1,waiting,9
2,22,769.5,559.9,366,1164,1530,2,targOff,9
2,23,942.7,548.4,1646,-255,1391,1,waiting,9
2,23,1135.2,541.1,462,1418,1880,2,targOff,9
2,24,938.4,537.5,1164,-35,1129,1,waiting,9
2,24,1129.9,540.3,440,1158,1598,2,targOff,9
2,25,939.2,544.1,1430,-192,1238,1,waiting,9
2,25,761.5,557.7,422,1294,1716,2,targOff,9
2,26,938.8,539.6,1605,-249,1356,1,waiting,9
2,26,769.1,548.6,464,1384,1848,2,targOff,9
2,27,942.6,550.8,1462,-263,1199,1,waiting,9
2,27,766.9,551.8,451,1247,1698,2,targOff,9
2,28,934.5,543.4,1537,-260,1277,1,waiting,9
2,28,781.9,555.9,466,1313,1779,2,targOff,9
2,29,941.9,544.2,1278,-260,1018,1,waiting,9
2,29,775.1,548.4,444,1054,1498,2,targOff,9
2,30,945.1,542.5,1512,-262,1250,1,waiting,9
2,30,1117.7,537.5,437,1277,1714,2,targOff,9
2,31,941.1,546.2,1372,-259,1113,1,waiting,9
2,31,1104.1,533.9,406,1138,1544,2,targOff,9
2,32,901.5,545.3,169,-148,21,1,waiting,9
2,32,943,538.4,1189,36,1225,2,waiting,9
2,32,1110.2,539.2,411,1251,1662,3,targOff,9
2,33,979.7,543.6,136,-111,25,1,waiting,9
2,33,942,540.9,1085,44,1129,2,waiting,9
2,33,762.7,549.8,427,1171,1598,3,targOff,9
2,34,934.2,550.4,1316,-261,1055,1,waiting,9
2,34,789.9,550.1,449,1099,1548,2,targOff,9
2,35,940.5,547.7,1530,-262,1268,1,waiting,9
2,35,1124.6,533.1,464,1299,1763,2,targOff,9
2,36,939.2,546.5,1226,-34,1192,1,waiting,9
2,36,776.1,552.7,437,1227,1664,2,targOff,9
2,37,940.9,546.1,1363,-192,1171,1,waiting,9
2,37,783.4,545.7,438,1226,1664,2,targOff,9
2,38,940.9,540.8,1680,-261,1419,1,waiting,9
2,38,1119,543.6,452,1446,1898,2,targOff,9
2,39,938.5,549.3,1472,-267,1205,1,waiting,9
2,39,784,561.8,445,1252,1697,2,targOff,9
2,40,944,547.4,1572,-269,1303,1,waiting,9
2,40,778.1,558.7,288,1351,1639,2,targOff,9
2,40,741,542.8,123,1657,1780,3,targOff,9
2,1,932.8,541.3,1820,11,1831,1,waiting,10
2,2,944.6,542.7,1877,-263,1614,1,waiting,10
2,3,936.2,543,1820,-108,1712,1,waiting,10
2,4,940.7,541.1,1777,-80,1697,1,waiting,10
2,5,944,542.9,1532,-260,1272,1,waiting,10
2,5,934.4,548.8,188,1289,1477,2,targOff,10
2,6,934.7,543.6,1962,-265,1697,1,waiting,10
2,7,940.7,547.1,1910,-262,1648,1,waiting,10
2,8,948.1,539.7,2066,-252,1814,1,waiting,10
2,9,945.8,534.4,1695,-265,1430,1,waiting,10
2,10,945.2,547.8,1931,-250,1681,1,waiting,10
2,11,947.5,542.2,1886,-256,1630,1,waiting,10
2,12,939.3,548.3,2135,-254,1881,1,waiting,10
2,13,957.9,558.3,299,-263,36,1,waiting,10
2,13,948.3,545.8,1502,45,1547,2,waiting,10
2,13,942.1,540.4,198,1566,1764,3,targOff,10
2,14,945.9,544.3,1950,-253,1697,1,waiting,10
2,15,951.8,542.8,265,-260,5,1,waiting,10
2,15,942.9,540.5,1699,12,1711,2,waiting,10
2,16,931.5,551,1901,-254,1647,1,waiting,10
2,17,960.3,550.9,380,-260,120,1,waiting,10
2,17,935,559.1,1664,132,1796,2,waiting,10
2,18,938.4,548.9,1004,-253,751,1,waiting,10
2,18,939,549.1,1019,761,1780,2,waiting,10
2,19,937,546.7,870,-251,619,1,waiting,10
2,19,935.8,545.4,1059,638,1697,2,waiting,10
2,20,939.9,551.9,1884,-259,1625,1,waiting,10
2,20,923.4,547.9,245,1648,1893,2,targOff,10
2,21,936.7,549.6,2089,-258,1831,1,waiting,10
2,22,943.5,543.3,1815,-252,1563,1,waiting,10
2,23,945.8,541.8,1902,-254,1648,1,waiting,10
2,24,945.4,542.9,1731,-34,1697,1,waiting,10
2,25,941.5,548.4,2012,-249,1763,1,waiting,10
2,26,942.3,546.6,2021,-260,1761,1,waiting,10
2,27,946,546.7,1800,-253,1547,1,waiting,10
2,28,934.9,550.7,1914,-251,1663,1,waiting,10
2,28,931.5,547.2,142,1672,1814,2,targOff,10
2,29,940.6,544.1,1687,-256,1431,1,waiting,10
2,29,934.9,542.9,213,1451,1664,2,targOff,10
2,30,940.2,547.8,2119,-255,1864,1,waiting,10
2,31,939.4,542,1857,-260,1597,1,waiting,10
2,32,934.3,548.3,1937,-260,1677,1,waiting,10
2,33,939,546.9,1746,-249,1497,1,waiting,10
2,34,940.3,548.7,2115,-268,1847,1,waiting,10
2,35,943.5,542.1,1688,-260,1428,1,waiting,10
2,36,936,547.1,1838,-258,1580,1,waiting,10
2,37,939.1,551.9,1691,-260,1431,1,waiting,10
2,38,930.1,521.7,264,-254,10,1,waiting,10
2,38,934.8,546.5,284,20,304,2,waiting,10
2,38,937.6,547.2,1569,311,1880,3,waiting,10
2,39,947,538.4,1887,-23,1864,1,waiting,10
2,40,945.4,548.6,1705,-258,1447,1,waiting,10
2,1,933.5,583.4,644,554,1198,1,waiting,11
2,2,901.2,545.7,140,-109,31,1,waiting,11
2,2,937.1,536,1233,43,1276,2,waiting,11
2,2,1118.8,536.4,407,1324,1731,3,targOff,11
2,3,939.1,540.6,1882,-262,1620,1,waiting,11
2,3,1118.8,536.1,282,1649,1931,2,targOff,11
2,4,936.2,541.7,1360,-251,1109,1,waiting,11
2,4,762,542.1,564,1167,1731,2,dotOff,11
2,5,942.1,535.7,1562,-260,1302,1,waiting,11
2,5,1125.3,541.3,477,1336,1813,2,targOff,11
2,6,932.4,533.4,1472,-31,1441,1,waiting,11
2,6,776.2,549.5,461,1466,1927,2,targOff,11
2,7,938.3,535,1392,-253,1139,1,waiting,11
2,7,1131.8,540.7,434,1164,1598,2,targOff,11
2,8,933.6,549.9,1142,-34,1108,1,waiting,11
2,8,777.2,552.5,458,1156,1614,2,targOff,11
2,9,934.8,547.6,1418,-253,1165,1,waiting,11
2,9,768.8,543.4,246,1218,1464,2,targOff,11
2,10,931.9,548.5,1473,-258,1215,1,waiting,11
2,10,1112.5,534.5,302,1245,1547,2,targOff,11
2,11,974.3,545.5,247,-208,39,1,waiting,11
2,11,934,547.5,1120,60,1180,2,waiting,11
2,11,780.2,554.7,454,1227,1681,3,targOff,11
2,12,955.1,551,132,-130,2,1,waiting,11
2,12,940.3,548.4,423,20,443,2,waiting,11
2,12,936.7,544.9,729,461,1190,3,waiting,11
2,12,1129.8,539.6,477,1216,1693,4,targOff,11
2,13,931,541.4,1275,-259,1016,1,waiting,11
2,13,1108.5,543.2,407,1039,1446,2,targOff,11
2,14,942.5,538.1,1407,-219,1188,1,waiting,11
2,14,1107.9,543.8,404,1226,1630,2,targOff,11
2,15,979.9,533.9,274,-258,16,1,waiting,11
2,15,944.3,538.2,144,36,180,2,waiting,11
2,15,932.1,534.2,256,195,451,3,waiting,11
2,15,939.8,546.3,933,467,1400,4,waiting,11
2,15,761,551.1,479,1435,1914,5,targOff,11
2,16,932,544,1579,-254,1325,1,waiting,11
2,16,778.9,562,478,1353,1831,2,targOff,11
2,17,945.1,544.7,1269,-260,1009,1,waiting,11
2,17,772.7,557.8,438,1055,1493,2,targOff,11
2,18,941.5,547.7,1685,-261,1424,1,waiting,11
2,18,779.2,550.9,434,1461,1895,2,targOff,11
2,19,938.1,545.5,1305,-262,1043,1,waiting,11
2,19,1127.4,542.3,460,1070,1530,2,targOff,11
2,20,938,547.9,1302,-260,1042,1,waiting,11
2,20,768.4,560.2,449,1078,1527,2,targOff,11
2,21,941.3,539.4,1519,-260,1259,1,waiting,11
2,21,1118,553.3,441,1285,1726,2,targOff,11
2,22,949.1,547.4,1505,-259,1246,1,waiting,11
2,22,1126.7,534.8,473,1272,1745,2,targOff,11
2,23,944.4,552.1,1414,-261,1153,1,waiting,11
2,23,785.3,556,457,1190,1647,2,targOff,11
2,24,946.3,552.2,1302,-254,1048,1,waiting,11
2,24,1115.8,551.8,425,1072,1497,2,targOff,11
2,25,960,547.2,376,-260,116,1,waiting,11
2,25,935.5,559.7,125,135,260,2,waiting,11
2,25,947.3,559.4,941,268,1209,3,waiting,11
2,25,1118.8,542.1,391,1236,1627,4,targOff,11
2,26,943.9,549.3,1190,-254,936,1,waiting,11
2,26,777.4,547.3,462,968,1430,2,targOff,11
2,27,942.8,543.3,1180,-135,1045,1,waiting,11
2,27,1118,535.8,442,1069,1511,2,targOff,11
2,28,940,550.4,1192,-32,1160,1,waiting,11
2,28,1126.6,540.8,457,1187,1644,2,targOff,11
2,29,939.1,540.8,1274,-187,1087,1,waiting,11
2,29,788.6,550.2,451,1130,1581,2,targOff,11
2,30,942.3,544.9,1548,-260,1288,1,waiting,11
2,30,1120.6,534.4,450,1313,1763,2,targOff,11
2,31,938.2,550.2,1231,-260,971,1,waiting,11
2,31,1111.8,546,417,997,1414,2,targOff,11
2,32,986.1,542.1,142,-134,8,1,waiting,11
2,32,939.3,555.9,1260,32,1292,2,waiting,11
2,32,1116.4,541.2,478,1319,1797,3,targOff,11
2,33,934.2,545,619,-251,368,1,waiting,11
2,33,938.8,549.6,65,384,449,2,waiting,11
2,33,921.4,541.6,84,467,551,3,waiting,11
2,33,935.3,537.2,738,567,1305,4,waiting,11
2,33,767.7,551.1,411,1353,1764,5,targOff,11
2,34,939.6,538.4,1262,-250,1012,1,waiting,11
2,34,911.1,535,120,1026,1146,2,targVis,11
2,34,786.6,546.7,359,1188,1547,3,targOff,11
2,35,947,545.1,447,-249,198,1,waiting,11
2,35,948.6,546,1042,211,1253,2,waiting,11
2,35,1131.2,534.2,429,1284,1713,3,targOff,11
2,36,936.4,537.8,337,-260,77,1,waiting,11
2,36,945.1,548.5,977,94,1071,2,waiting,11
2,36,780.2,545.8,319,1103,1422,3,targOff,11
2,36,752.5,547.5,108,1451,1559,4,targOff,11
2,37,940.8,546.1,1685,-259,1426,1,waiting,11
2,37,1121.1,543.8,427,1453,1880,2,targOff,11
2,38,936.5,545.7,1490,-260,1230,1,waiting,11
2,38,1109.4,537.2,453,1256,1709,2,targOff,11
2,39,974.3,538.8,156,-128,28,1,waiting,11
2,39,937.3,545.6,1142,50,1192,2,waiting,11
2,39,1108.7,543.7,443,1218,1661,3,targOff,11
2,40,942.3,534.8,1314,-2,1312,1,waiting,11
2,40,1116.1,536.2,457,1340,1797,2,targOff,11
2,1,1015.1,530.6,280,-253,27,1,waiting,12
2,1,977.9,539.9,1556,41,1597,2,waiting,12
2,2,966.5,538.5,1790,-260,1530,1,waiting,12
2,3,966.6,541.5,1728,-68,1660,1,waiting,12
2,4,968.2,537.4,1669,-255,1414,1,waiting,12
2,5,967.9,538.2,1854,-260,1594,1,waiting,12
2,6,960.4,541.8,2068,-254,1814,1,waiting,12
2,7,964.7,537.5,2027,-263,1764,1,waiting,12
2,8,960.4,538.6,1851,-254,1597,1,waiting,12
2,9,965.3,537.1,1966,-252,1714,1,waiting,12
2,10,960.6,537.4,1549,-6,1543,1,waiting,12
2,11,955.6,544.3,1718,-254,1464,1,waiting,12
2,12,950.6,544.4,1795,-247,1548,1,waiting,12
2,13,967.5,542.8,1932,-55,1877,1,waiting,12
2,14,957.4,549.8,1673,-260,1413,1,waiting,12
2,15,958.6,540.6,1874,-260,1614,1,waiting,12
2,16,956.4,541.5,2080,-266,1814,1,waiting,12
2,17,957.7,550.7,1625,-161,1464,1,waiting,12
2,18,955.6,539.9,1754,-260,1494,1,waiting,12
2,19,957.3,546.1,1766,-251,1515,1,waiting,12
2,20,952.2,545.5,2055,-257,1798,1,waiting,12
2,21,948.4,548.3,1971,-260,1711,1,waiting,12
2,22,959.2,544.3,1700,-252,1448,1,waiting,12
2,23,956.7,544.8,2117,-253,1864,1,waiting,12
2,24,958.3,547.7,2025,-178,1847,1,waiting,12
2,25,956.7,539.6,1934,-253,1681,1,waiting,12
2,26,953.6,554.3,1641,7,1648,1,waiting,12
2,27,956.8,543.4,1732,-251,1481,1,waiting,12
2,28,955.8,544.3,1581,-134,1447,1,waiting,12
2,29,952.3,548.8,1666,-18,1648,1,waiting,12
2,30,955,548.3,1938,-259,1679,1,waiting,12
2,31,955.9,550.8,2124,-260,1864,1,waiting,12
2,32,963.4,547,215,-33,182,1,waiting,12
2,32,960.3,542.8,1265,199,1464,2,waiting,12
2,33,946.1,550,1907,-260,1647,1,waiting,12
2,34,953.1,549.8,1984,-254,1730,1,waiting,12
2,35,948.7,551.7,1665,-251,1414,1,waiting,12
2,36,956.8,549,2148,-251,1897,1,waiting,12
2,37,954.7,548.8,2017,-253,1764,1,waiting,12
2,38,961.1,543.1,365,-252,113,1,waiting,12
2,38,951.2,548.7,1702,129,1831,2,waiting,12
2,39,961.4,544.3,1603,-123,1480,1,waiting,12
2,40,950.7,544.7,1722,-259,1463,1,waiting,12
2,1,1020.7,547.8,258,-257,1,1,waiting,13
2,1,954.5,547.6,1390,26,1416,2,waiting,13
2,1,1122.4,541.1,439,1442,1881,3,targOff,13
2,2,955.4,541.4,1259,-255,1004,1,waiting,13
2,2,785.1,547.7,394,1037,1431,2,targOff,13
2,3,954.3,552,280,-255,25,1,waiting,13
2,3,952.7,555.2,1139,41,1180,2,waiting,13
2,3,1129.4,550,491,1206,1697,3,targOff,13
2,4,957.4,549.2,1074,-35,1039,1,waiting,13
2,4,1131.6,541.7,394,1070,1464,2,targOff,13
2,5,957.1,550.2,981,-38,943,1,waiting,13
2,5,1104.4,539.6,515,983,1498,2,dotOff,13
2,5,1151.3,548.5,123,1521,1644,3,targOff,13
2,6,960.8,547,1428,-260,1168,1,waiting,13
2,6,1139.5,546.5,446,1197,1643,2,targOff,13
2,7,958.3,547.5,1397,-51,1346,1,waiting,13
2,7,763.8,546.5,416,1394,1810,2,targOff,13
2,8,935.2,545.3,289,-259,30,1,waiting,13
2,8,958.3,544.3,1304,48,1352,2,waiting,13
2,8,783.7,537.4,431,1400,1831,3,targOff,13
2,9,946,529.6,162,-160,2,1,waiting,13
2,9,953.9,554,1374,18,1392,2,waiting,13
2,9,1127.7,549.9,431,1416,1847,3,targOff,13
2,10,960.5,542.4,1722,-260,1462,1,waiting,13
2,10,1137.2,547.4,437,1489,1926,2,targOff,13
2,11,951.9,550.7,1987,-259,1728,1,waiting,13
2,12,963.2,531.6,687,3,690,1,waiting,13
2,12,961.1,537.9,298,697,995,2,waiting,13
2,12,770.7,543.1,407,1039,1446,3,targOff,13
2,13,961.6,542.1,1490,-259,1231,1,waiting,13
2,13,1135,548.4,480,1264,1744,2,targOff,13
2,14,947.8,544.5,1345,-36,1309,1,waiting,13
2,14,1119.1,544.5,445,1333,1778,2,targOff,13
2,15,957.6,543.5,1538,-246,1292,1,waiting,13
2,15,777.6,526.2,456,1325,1781,2,targOff,13
2,16,949.3,551.1,1614,-253,1361,1,waiting,13
2,16,778.3,545,459,1405,1864,2,targOff,13
2,17,959.3,542.1,1428,-251,1177,1,waiting,13
2,17,1128.1,541,412,1203,1615,2,targOff,13
2,18,959,540.4,1440,-262,1178,1,waiting,13
2,18,768.3,539.3,408,1223,1631,2,targOff,13
2,19,953.1,539.8,1693,-259,1434,1,waiting,13
2,19,778.3,543,413,1463,1876,2,targOff,13
2,20,954.8,545.2,1457,-254,1203,1,waiting,13
2,20,1126.2,550,469,1228,1697,2,targOff,13
2,21,973.2,557.5,211,-38,173,1,waiting,13
2,21,953.9,550.6,1112,193,1305,2,waiting,13
2,21,1124.1,551.1,450,1330,1780,3,targOff,13
2,22,956.7,548,1504,-249,1255,1,waiting,13
2,22,782.6,542.3,427,1287,1714,2,targOff,13
2,23,953.4,546.4,1564,-248,1316,1,waiting,13
2,23,789.1,541.6,446,1351,1797,2,targOff,13
2,24,954.4,546.4,1431,-258,1173,1,waiting,13
2,24,786.1,547.4,262,1205,1467,2,targOff,13
2,24,762.8,551.3,186,1475,1661,3,targOff,13
2,25,958.5,548.4,1114,-30,1084,1,waiting,13
2,25,1117,546.5,422,1109,1531,2,targOff,13
2,26,966.2,551.8,210,-38,172,1,waiting,13
2,26,953.5,551.6,914,189,1103,2,waiting,13
2,26,783.5,551.3,476,1138,1614,3,targOff,13
2,27,960.8,540,1819,-267,1552,1,waiting,13
2,27,773.3,538.4,297,1583,1880,2,targOff,13
2,28,957.5,534.5,1458,-259,1199,1,waiting,13
2,28,1153,534.4,451,1226,1677,2,targOff,13
2,29,953.3,546.1,1481,-263,1218,1,waiting,13
2,29,1111.2,545.6,421,1243,1664,2,targOff,13
2,30,951,549.4,1199,-24,1175,1,waiting,13
2,30,1118.1,559.3,466,1198,1664,2,targOff,13
2,31,964.1,557.3,146,-107,39,1,waiting,13
2,31,955.6,554.5,1164,57,1221,2,waiting,13
2,31,781.2,556.1,463,1268,1731,3,targOff,13
2,32,961.4,543.6,1460,-33,1427,1,waiting,13
2,32,790.8,546.8,467,1463,1930,2,targOff,13
2,33,968.1,541.3,1127,-50,1077,1,waiting,13
2,33,764.7,547.3,434,1113,1547,2,targOff,13
2,34,965,546.8,1656,-258,1398,1,waiting,13
2,34,1139.9,538.7,473,1424,1897,2,targOff,13
2,35,959.1,546.3,1496,-254,1242,1,waiting,13
2,35,791.1,542.8,468,1279,1747,2,targOff,13
2,36,950.1,554.5,1522,-260,1262,1,waiting,13
2,36,1125.7,536.8,489,1288,1777,2,targOff,13
2,37,962.2,548.8,1345,-253,1092,1,waiting,13
2,37,1134.8,546.2,428,1120,1548,2,targOff,13
2,38,961.5,550.1,1416,-31,1385,1,waiting,13
2,38,1123.2,542.5,448,1431,1879,2,targOff,13
2,39,957.8,551.3,1609,-260,1349,1,waiting,13
2,39,1127.4,541.1,473,1374,1847,2,targOff,13
2,40,964.6,540.5,1580,-253,1327,1,waiting,13
2,40,776.8,548.5,452,1362,1814,2,targOff,13
2,1,956,554.3,238,23,261,1,waiting,14
2,1,956.4,540.5,1131,269,1400,2,waiting,14
2,1,747.2,530.9,213,1451,1664,3,targOff,14
2,2,954.4,542.6,1908,-261,1647,1,waiting,14
2,3,951.5,539.6,1677,-30,1647,1,waiting,14
2,4,952.7,538.5,1826,-262,1564,1,waiting,14
2,5,965,547.2,1748,-268,1480,1,waiting,14
2,6,982.6,539.6,432,-263,169,1,waiting,14
2,6,964.3,549.5,1370,177,1547,2,waiting,14
2,7,959.3,548.4,2175,-261,1914,1,waiting,14
2,8,954.7,550.3,1793,-261,1532,1,waiting,14
2,9,958.1,554.9,1838,-259,1579,1,waiting,14
2,10,956.4,548.2,1427,1,1428,1,waiting,14
2,11,952.2,550.5,1964,-251,1713,1,waiting,14
2,11,939.8,548.7,165,1732,1897,2,targOff,14
2,12,952.8,548.9,1728,-264,1464,1,waiting,14
2,13,945.4,545,2097,-250,1847,1,waiting,14
2,14,957.9,542.3,1909,-262,1647,1,waiting,14
2,15,952.8,551.6,1862,-249,1613,1,waiting,14
2,16,947.9,544.6,1995,-265,1730,1,waiting,14
2,17,957.2,548,1511,-48,1463,1,waiting,14
2,18,955.5,546.7,1707,-260,1447,1,waiting,14
2,19,959.4,544.1,1790,-43,1747,1,waiting,14
2,20,959.3,544.2,1906,-260,1646,1,waiting,14
2,21,959.1,548.6,1767,-253,1514,1,waiting,14
2,22,960.2,550.8,1182,32,1214,1,waiting,14
2,23,850.5,560.2,152,-145,7,1,waiting,14
2,23,952.1,551.4,1819,29,1848,2,waiting,14
2,24,950.3,544,1883,-252,1631,1,waiting,14
2,25,948.2,555.4,1947,-249,1698,1,waiting,14
2,26,954,549.5,1777,-261,1516,1,waiting,14
2,26,776.1,549.1,225,1573,1798,2,targOff,14
2,27,959,545.3,1749,-189,1560,1,waiting,14
2,28,948.5,550.4,1900,-253,1647,1,waiting,14
2,29,955.8,552,1973,-259,1714,1,waiting,14
2,30,955.6,556.3,1681,-101,1580,1,waiting,14
2,31,955.9,551.9,2173,-259,1914,1,waiting,14
2,32,955.7,553,1984,-253,1731,1,waiting,14
2,33,956.1,553.1,2014,-103,1911,1,waiting,14
2,34,954.6,553.1,1709,-262,1447,1,waiting,14
2,35,954.4,559.9,1124,-253,871,1,waiting,14
2,35,957.7,555.5,499,887,1386,2,dotOff,14
2,35,1062.9,545.9,106,1408,1514,3,targOff,14
2,36,957.4,558.5,1470,-27,1443,1,waiting,14
2,37,965.3,568.4,254,-254,0,1,waiting,14
2,37,963.5,551.3,1772,9,1781,2,waiting,14
2,38,960.4,558,1940,-26,1914,1,waiting,14
2,39,972.7,544.1,149,-32,117,1,waiting,14
2,39,941.7,549.3,1677,137,1814,2,waiting,14
2,40,956.6,551.6,2080,-266,1814,1,waiting,14
2,1,1031.3,553.3,263,-254,9,1,waiting,15
2,1,951.5,547.3,1031,34,1065,2,waiting,15
2,1,1127.8,541.3,388,1093,1481,3,targOff,15
2,2,949.4,551.4,1286,-252,1034,1,waiting,15
2,2,776.1,549.3,498,1082,1580,2,targOff,15
2,3,955.2,543.7,1597,-261,1336,1,waiting,15
2,3,1133.5,545.2,503,1361,1864,2,targOff,15
2,4,956.5,555.3,1449,-250,1199,1,waiting,15
2,4,789.2,555.6,468,1247,1715,2,targOff,15
2,5,955.2,545.8,1160,-158,1002,1,waiting,15
2,5,776.7,545.6,449,1049,1498,2,targOff,15
2,6,943.7,545.2,266,-27,239,1,waiting,15
2,6,967.5,546.7,151,248,399,2,waiting,15
2,6,956.7,545.3,917,418,1335,3,waiting,15
2,6,1135.8,551.5,436,1361,1797,4,targOff,15
2,7,953.1,543.3,1627,-258,1369,1,waiting,15
2,7,785.5,565.5,447,1415,1862,2,targOff,15
2,8,954.1,553.9,144,-144,0,1,waiting,15
2,8,955.7,535.5,1782,16,1798,2,waiting,15
2,9,975.6,537.3,1155,-4,1151,1,waiting,15
2,9,796,539.4,446,1201,1647,2,targOff,15
2,10,946.5,538.9,922,-60,862,1,waiting,15
2,10,940.6,533.5,419,878,1297,2,waiting,15
2,10,1131.9,543.3,475,1323,1798,3,targOff,15
2,11,951.8,527.4,1496,-260,1236,1,waiting,15
2,11,786.2,543.4,170,1267,1437,2,targOff,15
2,11,783.3,547.8,302,1446,1748,3,targOff,15
2,12,952,551.5,1067,-49,1018,1,waiting,15
2,12,1119.8,546.9,437,1048,1485,2,targOff,15
2,13,944.3,559.9,1252,-46,1206,1,waiting,15
2,13,1126.2,550.6,446,1231,1677,2,targOff,15
2,14,953.4,561.3,1258,-259,999,1,waiting,15
2,14,1124.1,545.8,455,1025,1480,2,targOff,15
2,15,962.7,553.4,1478,-265,1213,1,waiting,15
2,15,1125.2,537.5,214,1250,1464,2,targOff,15
2,16,956.3,553.5,1368,-254,1114,1,waiting,15
2,16,1101.5,553.3,410,1138,1548,2,targOff,15
2,17,896,553.1,267,-259,8,1,waiting,15
2,17,949.2,553.8,1411,22,1433,2,waiting,15
2,17,780.9,559.7,454,1477,1931,3,targOff,15
2,18,949.1,554,1548,-253,1295,1,waiting,15
2,18,1127.2,550.7,441,1323,1764,2,targOff,15
2,19,954.2,548.1,1674,-258,1416,1,waiting,15
2,19,1132.7,555.6,451,1446,1897,2,targOff,15
2,20,948,550.3,1258,-58,1200,1,waiting,15
2,20,783.3,546.2,450,1230,1680,2,targOff,15
2,21,949.3,550.3,1305,-200,1105,1,waiting,15
2,21,1119.8,552,306,1140,1446,2,targOff,15
2,22,946.5,554.5,1450,-261,1189,1,waiting,15
2,22,938.1,547.4,196,1208,1404,2,dotOff,15
2,22,1119.4,547.1,446,1435,1881,3,targOff,15
2,23,951,551.5,1247,-259,988,1,waiting,15
2,23,1117,549,418,1012,1430,2,targOff,15
2,24,953.7,547,1203,-180,1023,1,waiting,15
2,24,790.5,548.2,481,1066,1547,2,targOff,15
2,25,951.1,547.3,1375,-50,1325,1,waiting,15
2,25,1128.5,540.2,480,1350,1830,2,targOff,15
2,26,952.5,553.6,1154,-81,1073,1,waiting,15
2,26,789.3,559.6,305,1118,1423,2,targOff,15
2,26,766.9,547.5,134,1444,1578,3,targOff,15
2,27,958.6,548.8,1506,-253,1253,1,waiting,15
2,27,1134.3,549,466,1281,1747,2,targOff,15
2,28,956.1,554.2,1353,-260,1093,1,waiting,15
2,28,1128.2,548.6,463,1118,1581,2,targOff,15
2,29,947,563.9,1263,-259,1004,1,waiting,15
2,29,1114.5,552.8,446,1030,1476,2,targOff,15
2,30,965.7,547.6,1184,-41,1143,1,waiting,15
2,30,1132.8,550.1,437,1175,1612,2,targOff,15
2,31,952.1,558.2,1218,-260,958,1,waiting,15
2,31,781.7,569.9,456,990,1446,2,targOff,15
2,32,964.5,545.6,1661,-249,1412,1,waiting,15
2,32,796.4,557.3,441,1454,1895,2,targOff,15
2,33,952.6,547.5,1449,-267,1182,1,waiting,15
2,33,791.3,557.2,469,1228,1697,2,targOff,15
2,34,957.1,556,1506,-259,1247,1,waiting,15
2,34,1123,554.4,436,1274,1710,2,targOff,15
2,35,949.6,548.2,1518,-260,1258,1,waiting,15
2,35,1114.5,553.6,462,1283,1745,2,targOff,15
2,36,949.4,556.8,1357,-63,1294,1,waiting,15
2,36,1119.1,562.6,461,1320,1781,2,targOff,15
2,37,963.6,547.9,206,-32,174,1,waiting,15
2,37,948.3,548.2,974,183,1157,2,waiting,15
2,37,790.7,554.2,458,1189,1647,3,targOff,15
2,38,953.7,545.7,1453,-248,1205,1,waiting,15
2,38,1125.8,555.2,451,1230,1681,2,targOff,15
2,39,949.2,554.1,1405,-258,1147,1,waiting,15
2,39,788,563.1,437,1193,1630,2,targOff,15
2,40,952.3,554,1378,-40,1338,1,waiting,15
2,40,1135.3,547.6,482,1366,1848,2,targOff,15
2,1,1061.5,531.2,202,-199,3,1,waiting,16
2,1,967.3,539.4,1405,26,1431,2,waiting,16
2,2,958.6,538.9,1835,-264,1571,1,waiting,16
2,3,954.9,539.2,1742,-261,1481,1,waiting,16
2,4,958.6,546.3,1848,-251,1597,1,waiting,16
2,5,960.7,547.4,2041,-261,1780,1,waiting,16
2,6,962.7,532.6,2030,-266,1764,1,waiting,16
2,7,957.7,554.2,2045,-264,1781,1,waiting,16
2,8,954.8,540,877,-208,669,1,waiting,16
2,8,954.1,553.7,270,843,1113,2,waiting,16
2,9,960,548.3,1434,-3,1431,1,waiting,16
2,10,963.3,542.2,1695,-248,1447,1,waiting,16
2,11,954.9,529.3,691,-256,435,1,waiting,16
2,11,955.5,555.6,368,612,980,2,waiting,16
2,12,957.1,547.6,2071,-190,1881,1,waiting,16
2,13,952.7,553.4,1721,-57,1664,1,waiting,16
2,14,963.3,538.4,1365,-248,1117,1,waiting,16
2,14,949.2,530,616,1132,1748,2,dotOff,16
2,15,962.6,540.9,1809,-28,1781,1,waiting,16
2,16,958.7,538.8,1751,-254,1497,1,waiting,16
2,17,959.9,551,1715,-268,1447,1,waiting,16
2,18,961.4,545.4,1656,-252,1404,1,waiting,16
2,18,955.3,551.3,333,1420,1753,2,targOff,16
2,18,968.8,542.1,143,1771,1914,3,targOff,16
2,19,952.1,540,271,-76,195,1,waiting,16
2,19,947.7,557.8,1480,218,1698,2,waiting,16
2,20,948.7,547.2,1855,-260,1595,1,waiting,16
2,21,952.9,541.1,133,-40,93,1,waiting,16
2,21,950.9,548,1813,101,1914,2,waiting,16
2,22,952.1,554.3,1741,-260,1481,1,waiting,16
2,23,957.5,551.5,1680,-16,1664,1,waiting,16
2,24,957.1,546.8,272,-266,6,1,waiting,16
2,24,947.9,544.4,321,14,335,2,waiting,16
2,24,948.5,548.3,619,478,1097,3,waiting,16
2,25,948.9,549.9,1779,1,1780,1,waiting,16
2,26,949.2,545.1,1925,-261,1664,1,waiting,16
2,27,953,621.8,200,-47,153,1,waiting,16
2,27,957.5,551.7,1453,160,1613,2,waiting,16
2,28,953.9,553.4,1692,-261,1431,1,waiting,16
2,29,952.5,558.3,1715,-251,1464,1,waiting,16
2,30,957.3,548.6,2133,-252,1881,1,waiting,16
2,31,950.5,555.7,2122,-257,1865,1,waiting,16
2,32,949.8,551.6,1664,-67,1597,1,waiting,16
2,32,944.4,575.1,150,1747,1897,2,targOff,16
2,33,913.1,567.1,177,118,295,1,waiting,16
2,33,944,563.6,556,308,864,2,waiting,16
2,34,964.4,547,173,-158,15,1,waiting,16
2,34,955.6,547,1666,31,1697,2,waiting,16
2,35,949.7,558.8,1611,-32,1579,1,waiting,16
2,36,955.2,566.8,1626,4,1630,1,waiting,16
2,37,956.7,536.3,879,-260,619,1,waiting,16
2,37,958.8,537.6,369,626,995,2,waiting,16
2,37,956.6,552.4,554,1006,1560,3,dotOff,16
2,38,955.2,553.9,2012,-248,1764,1,waiting,16
2,39,949,550.7,276,-40,236,1,waiting,16
2,39,955.4,547.3,1603,244,1847,2,waiting,16
2,40,959.6,529.5,268,-257,11,1,waiting,16
2,40,955.1,542.8,1766,31,1797,2,waiting,16
2,1,943,554.1,295,-250,45,1,waiting,17
2,1,964.4,545.1,195,59,254,2,waiting,17
2,1,956.1,543.7,744,261,1005,3,waiting,17
2,1,1119.7,539.9,399,1031,1430,4,targOff,17
2,2,953.6,553,1209,-252,957,1,waiting,17
2,2,781.9,541.4,511,1003,1514,2,targOff,17
2,3,953.7,552.7,1108,-32,1076,1,waiting,17
2,3,818.1,553.9,302,1112,1414,2,dotOff,17
2,3,774.6,557.4,301,1446,1747,3,targOff,17
2,4,954.2,557.6,347,-257,90,1,waiting,17
2,4,953.3,557.8,1018,99,1117,2,waiting,17
2,4,782.2,549,411,1183,1594,3,targOff,17
2,5,948.4,549.3,1538,-250,1288,1,waiting,17
2,5,1123.4,555.7,412,1317,1729,2,targOff,17
2,6,950.4,555.2,557,-248,309,1,waiting,17
2,6,942.9,558.4,253,316,569,2,waiting,17
2,6,955.2,555.7,910,587,1497,3,waiting,17
2,7,854.3,519.1,196,547,743,1,waiting,17
2,7,951.1,550.4,363,780,1143,2,waiting,17
2,8,955.8,536.8,1162,-158,1004,1,waiting,17
2,8,785.3,535.9,401,1063,1464,2,targOff,17
2,9,955.5,542.6,1455,-259,1196,1,waiting,17
2,9,1132.1,551.4,475,1221,1696,2,targOff,17
2,10,954,548.3,1319,-31,1288,1,waiting,17
2,10,1137.8,554.1,479,1318,1797,2,targOff,17
2,11,959.9,548.7,1396,-29,1367,1,waiting,17
2,11,794.8,538.4,447,1413,1860,2,targOff,17
2,12,955.5,544.3,1243,-35,1208,1,waiting,17
2,12,1128.1,548.3,448,1233,1681,2,targOff,17
2,13,950.5,549.4,1343,-261,1082,1,waiting,17
2,13,1090.8,550.8,276,1106,1382,2,targOff,17
2,13,1134.2,539.8,94,1404,1498,3,targOff,17
2,14,953.8,555.3,924,-234,690,1,waiting,17
2,14,770.9,560.6,358,722,1080,2,waiting,17
2,15,975.1,539.7,123,-106,17,1,waiting,17
2,15,951.3,550.3,1152,38,1190,2,waiting,17
2,15,1101.2,556,413,1218,1631,3,targOff,17
2,16,950.1,548.7,683,-15,668,1,waiting,17
2,16,948.6,549.6,335,676,1011,2,waiting,17
2,16,1117.1,555.6,376,1051,1427,3,targOff,17
2,17,949.7,569.9,1304,-32,1272,1,waiting,17
2,17,1110.2,570.1,430,1300,1730,2,targOff,17
2,18,1003.9,558.2,133,-133,0,1,waiting,17
2,18,954.2,557.7,1219,29,1248,2,waiting,17
2,18,774.3,555.6,432,1295,1727,3,targOff,17
2,19,940.7,548.2,476,-260,216,1,waiting,17
2,19,962.7,556.4,831,234,1065,2,waiting,17
2,19,773.1,551.1,407,1124,1531,3,targOff,17
2,20,954.3,560,1040,-10,1030,1,waiting,17
2,20,806.1,570.6,403,1061,1464,2,targOff,17
2,21,954.2,558,1719,-260,1459,1,waiting,17
2,22,952.1,555.7,1394,-21,1373,1,waiting,17
2,22,1119.6,555.9,467,1413,1880,2,targOff,17
2,23,953,557.8,1369,-252,1117,1,waiting,17
2,23,1129,545.4,432,1149,1581,2,targOff,17
2,24,948,566.1,1356,-255,1101,1,waiting,17
2,24,775.9,555.8,399,1148,1547,2,targOff,17
2,25,953.5,553.8,1428,-259,1169,1,waiting,17
2,25,788.3,561.6,477,1204,1681,2,targOff,17
2,26,951.2,557.4,1451,-47,1404,1,waiting,17
2,26,781.2,553,366,1448,1814,2,targOff,17
2,27,952.6,546.2,1295,-259,1036,1,waiting,17
2,27,1128,555.7,449,1062,1511,2,targOff,17
2,28,953.3,552.8,1013,-64,949,1,waiting,17
2,28,790.4,549.6,463,980,1443,2,targOff,17
2,29,936.7,552.1,1778,-258,1520,1,waiting,17
2,29,828.8,545.4,128,1553,1681,2,targOff,17
2,30,947.3,553.7,1104,24,1128,1,waiting,17
2,30,776.2,551.6,440,1174,1614,2,targOff,17
2,31,970.8,556.7,209,-26,183,1,waiting,17
2,31,942.2,558.7,789,195,984,2,waiting,17
2,31,767.4,565.4,434,1030,1464,3,targOff,17
2,32,950.6,555.1,1601,-262,1339,1,waiting,17
2,32,1114.8,551.8,479,1368,1847,2,targOff,17
2,33,948.7,549.8,983,-67,916,1,waiting,17
2,33,935.3,552,131,935,1066,2,dotOff,17
2,33,1132.3,551.1,219,1092,1311,3,targOff,17
2,33,1133.5,563.8,83,1448,1531,4,targOff,17
2,34,957.8,555.2,1084,-1,1083,1,waiting,17
2,34,1116.7,556.2,553,1111,1664,2,dotOff,17
2,35,949.7,545.6,676,-258,418,1,waiting,17
2,35,945.7,551.3,525,437,962,2,waiting,17
2,35,1124,553,194,987,1181,3,waiting,17
2,36,927.3,563,274,-35,239,1,waiting,17
2,36,945.6,569.3,877,254,1131,2,waiting,17
2,36,942.2,573.8,199,1244,1443,3,targOff,17
2,36,1122.7,553.3,201,1480,1681,4,targOff,17
2,37,934.4,553,144,-71,73,1,waiting,17
2,37,953.1,561.3,269,91,360,2,waiting,17
2,37,947.3,562.4,817,378,1195,3,waiting,17
2,37,1114.7,552.6,469,1224,1693,4,targOff,17
2,38,956.9,559.7,1100,-44,1056,1,waiting,17
2,38,784.9,566.9,404,1110,1514,2,targOff,17
2,39,946.6,559,276,-50,226,1,waiting,17
2,39,956.3,566.6,834,246,1080,2,waiting,17
2,39,1130.9,557.3,470,1111,1581,3,targOff,17
2,40,951.1,563,1690,-260,1430,1,waiting,17
2,40,1088.7,563.4,321,1455,1776,2,targOff,17
2,40,1132.1,562.7,58,1801,1859,3,targOff,17
2,1,1092.7,543,264,-254,10,1,waiting,18
2,1,953.8,549,1512,36,1548,2,waiting,18
2,2,954.1,553,1782,-251,1531,1,waiting,18
2,3,949.6,552,1709,-261,1448,1,waiting,18
2,4,950.5,558.5,1885,12,1897,1,waiting,18
2,5,951.8,570.3,1551,-4,1547,1,waiting,18
2,6,957.4,557.6,1911,-247,1664,1,waiting,18
2,7,955.6,556,1777,-80,1697,1,waiting,18
2,8,960.3,556.9,1836,-255,1581,1,waiting,18
2,9,953.8,556.6,2135,-259,1876,1,waiting,18
2,10,951.9,554.4,2036,-255,1781,1,waiting,18
2,11,950.2,553.5,1745,-56,1689,1,waiting,18
2,11,920.1,560,179,1701,1880,2,targOff,18
2,12,952.2,556.4,1730,-253,1477,1,waiting,18
2,12,1111.7,546.5,198,1499,1697,2,targOff,18
2,13,906.7,584.5,262,-251,11,1,waiting,18
2,13,942.6,562.3,1676,21,1697,2,waiting,18
2,14,938.2,561.4,1180,-165,1015,1,waiting,18
2,14,952.1,641.6,99,1365,1464,2,targOff,18
2,15,951.5,555.5,1918,-21,1897,1,waiting,18
2,16,940.6,555.2,1494,3,1497,1,waiting,18
2,17,936.9,565.3,1570,-262,1308,1,waiting,18
2,17,938.3,562.3,508,1322,1830,2,targOff,18
2,18,935.1,559.6,456,-183,273,1,waiting,18
2,18,946,559.7,1388,292,1680,2,waiting,18
2,19,952.7,563.3,242,-23,219,1,waiting,18
2,19,942,561.4,1605,226,1831,2,waiting,18
2,20,944.5,557.1,2025,-246,1779,1,waiting,18
2,21,937.9,561.6,556,21,577,1,waiting,18
2,21,947.5,570.9,1312,585,1897,2,waiting,18
2,22,942.6,556.1,1656,-242,1414,1,waiting,18
2,23,937.6,563.9,2086,-260,1826,1,waiting,18
2,24,950.7,547.1,1473,5,1478,1,waiting,18
2,25,936.7,553.7,1980,-250,1730,1,waiting,18
2,26,946.5,548.3,2018,-254,1764,1,waiting,18
2,27,937.7,549.9,1675,-45,1630,1,waiting,18
2,28,940.5,554.6,1573,-264,1309,1,waiting,18
2,28,876.6,533.1,154,1327,1481,2,targOff,18
2,29,937.3,554.5,1844,-264,1580,1,waiting,18
2,30,935,552.1,2029,-248,1781,1,waiting,18
2,31,935.8,551.8,2084,-253,1831,1,waiting,18
2,32,937.6,546.7,1966,-252,1714,1,waiting,18
2,33,942.2,555.2,1474,-27,1447,1,waiting,18
2,34,935.5,560.7,1971,-257,1714,1,waiting,18
2,35,944.6,556.2,1784,-236,1548,1,waiting,18
2,36,946.8,559.9,1945,-248,1697,1,waiting,18
2,37,940.6,558.1,1958,-260,1698,1,waiting,18
2,38,935.4,555.9,312,-33,279,1,waiting,18
2,38,936,565.1,1400,298,1698,2,waiting,18
2,39,937.2,560.4,1613,-17,1596,1,waiting,18
2,39,1016.7,550,133,1615,1748,2,targOff,18
2,40,937.1,553.3,2077,-263,1814,1,waiting,18
2,1,1018.1,549.7,277,-254,23,1,waiting,19
2,1,939.4,548.5,1261,47,1308,2,waiting,19
2,1,769,554.8,457,1357,1814,3,targOff,19
2,2,941.1,559.5,923,9,932,1,waiting,19
2,2,935.6,551.2,84,950,1034,2,dotOff,19
2,2,1115.4,550.7,450,1061,1511,3,targOff,19
2,3,941.9,553.2,1655,-262,1393,1,waiting,19
2,3,752.9,563.3,375,1439,1814,2,targOff,19
2,4,939.2,546.4,1337,-171,1166,1,waiting,19
2,4,772.3,534.3,246,1202,1448,2,targOff,19
2,5,930.2,547.8,684,-54,630,1,waiting,19
2,5,933,548.2,490,654,1144,2,waiting,19
2,5,1106.4,554.8,443,1171,1614,3,targOff,19
2,6,1037.6,447.7,102,40,142,1,waiting,19
2,6,959.5,554.8,101,187,288,2,waiting,19
2,6,918.9,544.8,154,318,472,3,waiting,19
2,6,948.9,551.2,348,494,842,4,waiting,19
2,7,943,561,1356,-10,1346,1,waiting,19
2,7,1114.6,551.6,441,1373,1814,2,targOff,19
2,8,938.5,556.2,1374,-259,1115,1,waiting,19
2,8,1123.2,553,417,1147,1564,2,targOff,19
2,9,938.8,553.6,1450,-255,1195,1,waiting,19
2,9,764.4,552.2,474,1240,1714,2,targOff,19
2,10,949.5,559.1,1073,0,1073,1,waiting,19
2,10,1099.3,564.1,481,1098,1579,2,waiting,19
2,10,1120.5,562.7,281,1598,1879,3,targOff,19
2,11,959,561.2,150,-54,96,1,waiting,19
2,11,932.8,555.7,1044,113,1157,2,waiting,19
2,11,784.6,564,426,1203,1629,3,targOff,19
2,12,931.6,557.4,1428,-253,1175,1,waiting,19
2,12,772.4,565.6,438,1209,1647,2,targOff,19
2,13,938,560.9,1655,-253,1402,1,waiting,19
2,13,776.7,574.3,434,1447,1881,2,targOff,19
2,14,935,552.1,612,-171,441,1,waiting,19
2,14,939.1,550.5,834,459,1293,2,waiting,19
2,14,1109.7,552.7,464,1317,1781,3,targOff,19
2,15,938.3,551.2,541,16,557,1,waiting,19
2,15,932.6,556.4,640,581,1221,2,waiting,19
2,15,1101.5,551.3,397,1247,1644,3,targOff,19
2,16,938.7,557.5,1291,10,1301,1,waiting,19
2,16,772.8,561.2,435,1362,1797,2,targOff,19
2,17,937.4,554.1,1049,-71,978,1,waiting,19
2,17,1113.7,544.8,429,1002,1431,2,targOff,19
2,18,939.6,555,1190,-11,1179,1,waiting,19
2,18,1111.1,561.7,436,1208,1644,2,targOff,19
2,19,952.4,556.3,1081,-3,1078,1,waiting,19
2,19,1113.6,547.2,443,1104,1547,2,targOff,19
2,20,942.2,543.7,190,-175,15,1,waiting,19
2,20,939.3,567.7,514,25,539,2,waiting,19
2,20,927.7,559,483,547,1030,3,waiting,19
2,20,779.1,566.7,441,1073,1514,4,targOff,19
2,21,936.1,560.7,1496,-262,1234,1,waiting,19
2,21,777.8,567.7,437,1260,1697,2,targOff,19
2,22,941.7,557.6,1275,-251,1024,1,waiting,19
2,22,1110.9,555.7,431,1048,1479,2,targOff,19
2,23,930,565.5,1360,18,1378,1,waiting,19
2,23,780.2,560.6,456,1409,1865,2,targOff,19
2,24,943.6,561.4,252,-250,2,1,waiting,19
2,24,934.1,557.2,1116,20,1136,2,waiting,19
2,24,1126.5,558.7,462,1169,1631,3,targOff,19
2,25,935.5,555.3,1498,-261,1237,1,waiting,19
2,25,1110.1,558.5,431,1263,1694,2,targOff,19
2,26,936.1,550.4,1205,6,1211,1,waiting,19
2,26,774.2,565.6,425,1256,1681,2,targOff,19
2,27,930.3,561.1,1285,-262,1023,1,waiting,19
2,27,1119.4,558,646,1051,1697,2,waiting,19
2,28,937.3,560,498,24,522,1,waiting,19
2,28,926.8,564.2,505,538,1043,2,waiting,19
2,28,752.8,567.4,405,1099,1504,3,targOff,19
2,29,940.9,554.2,1135,1,1136,1,waiting,19
2,29,756.9,566.3,414,1184,1598,2,targOff,19
2,30,935.2,556.4,474,-261,213,1,waiting,19
2,30,932.5,563.4,974,229,1203,2,waiting,19
2,30,764.4,569.3,443,1232,1675,3,targOff,19
2,31,937.3,554.2,1363,-261,1102,1,waiting,19
2,31,941.7,554.4,259,1119,1378,2,dotOff,19
2,31,751.4,556.2,325,1422,1747,3,targOff,19
2,32,934.3,560.5,1533,-263,1270,1,waiting,19
2,32,1070.6,558,271,1293,1564,2,targOff,19
2,32,1111.6,547.4,111,1586,1697,3,targOff,19
2,33,940.5,553.8,1462,-264,1198,1,waiting,19
2,33,780.1,561.8,467,1230,1697,2,targOff,19
2,34,938,563.7,1509,-252,1257,1,waiting,19
2,34,781.3,563.7,410,1288,1698,2,targOff,19
2,35,935.5,565.5,1323,-265,1058,1,waiting,19
2,35,777.9,556.3,424,1091,1515,2,targOff,19
2,36,939.3,558.9,1433,-260,1173,1,waiting,19
2,36,1108.5,555.2,449,1198,1647,2,targOff,19
2,37,955.3,550.5,282,-259,23,1,waiting,19
2,37,943.4,546.6,974,41,1015,2,waiting,19
2,37,775.5,557.8,447,1048,1495,3,targOff,19
2,38,938.3,555.2,1465,-253,1212,1,waiting,19
2,38,1109.3,565.6,460,1237,1697,2,targOff,19
2,39,932.8,553.8,1246,-6,1240,1,waiting,19
2,39,776.3,558.7,396,1285,1681,2,targOff,19
2,40,937.1,553.7,1410,-33,1377,1,waiting,19
2,40,1110,548.9,439,1408,1847,2,targOff,19
2,1,964.7,557.8,244,-192,52,1,waiting,20
2,1,939.2,553.7,1587,73,1660,2,waiting,20
2,2,938.5,549.1,1844,-260,1584,1,waiting,20
2,2,944.8,545.7,53,1591,1644,2,targOff,20
2,3,935.6,548.1,1912,-248,1664,1,waiting,20
2,4,942.9,550.7,2145,-264,1881,1,waiting,20
2,5,938,550.1,877,-261,616,1,waiting,20
2,5,951.2,551.3,905,623,1528,2,waiting,20
2,6,940.6,550.8,1714,-262,1452,1,waiting,20
2,6,791.1,552.6,195,1486,1681,2,targOff,20
2,7,934.8,560.8,1024,39,1063,1,waiting,20
2,8,949.1,542.4,2005,-258,1747,1,waiting,20
2,9,947.3,547,1870,-259,1611,1,waiting,20
2,10,942.3,546.8,1964,-250,1714,1,waiting,20
2,11,961.4,541.7,306,-263,43,1,waiting,20
2,11,952.6,556.9,1707,59,1766,2,waiting,20
2,11,961.8,544.2,98,1783,1881,3,targOff,20
2,12,943.8,554.2,1872,-260,1612,1,waiting,20
2,13,948.2,550.8,1991,-260,1731,1,waiting,20
2,14,938.9,554.7,1792,-251,1541,1,waiting,20
2,15,945,546.9,2002,-258,1744,1,waiting,20
2,16,947.6,545.3,1554,-40,1514,1,waiting,20
2,17,942.5,547.8,2081,-250,1831,1,waiting,20
2,18,947.7,545.8,1770,-139,1631,1,waiting,20
2,19,943.9,548.8,1795,-260,1535,1,waiting,20
2,19,942.7,545,188,1543,1731,2,targOff,20
2,20,943.6,547.7,1588,-91,1497,1,waiting,20
2,21,955,557.6,242,-47,195,1,waiting,20
2,21,940.6,556.3,1536,211,1747,2,waiting,20
2,22,948.5,546.6,1524,13,1537,1,waiting,20
2,23,947.6,537.5,2018,-254,1764,1,waiting,20
2,24,941.8,540.8,2072,-208,1864,1,waiting,20
2,25,937.7,553.1,1706,-259,1447,1,waiting,20
2,26,946.3,546.6,1780,-33,1747,1,waiting,20
2,27,943,542.4,1539,-9,1530,1,waiting,20
2,28,952.4,539.7,1726,-12,1714,1,waiting,20
2,29,935.6,554.9,282,-267,15,1,waiting,20
2,29,946.1,556.4,1084,34,1118,2,waiting,20
2,29,939.9,553.8,647,1133,1780,3,dotOff,20
2,30,934.9,555.5,282,-263,19,1,waiting,20
2,30,940.6,551.9,1662,36,1698,2,waiting,20
2,31,944.4,547.4,1753,-260,1493,1,waiting,20
2,32,938.5,545.2,1720,-261,1459,1,waiting,20
2,32,939.2,538.6,22,1466,1488,2,targOff,20
2,32,956.2,541.9,47,1617,1664,3,targOff,20
2,33,932.9,550.4,799,81,880,1,waiting,20
2,34,942.2,551.5,1599,-2,1597,1,waiting,20
2,35,936.1,550.5,1710,-262,1448,1,waiting,20
2,36,937.3,560.3,1810,-165,1645,1,waiting,20
2,37,945.5,541.8,1768,-258,1510,1,waiting,20
2,38,945.5,545.3,1820,-258,1562,1,waiting,20
2,39,937,562.1,1761,-247,1514,1,waiting,20
2,40,943.7,555.4,2089,-259,1830,1,waiting,20
