person,trial,x,y,dur,on,off,n,timeInt,block
1,1,958.2,546.1,1425,-285,1140,1,waiting,1
1,1,788.6,547.8,480,1168,1648,2,targOff,1
1,2,964.3,549.2,1262,-270,992,1,waiting,1
1,2,791.9,549.1,478,1019,1497,2,targOff,1
1,3,964.3,546.3,1245,-272,973,1,waiting,1
1,3,1167.9,555.9,166,1000,1166,2,waiting,1
1,3,1137.5,555,555,1176,1731,3,targVis,1
1,4,967.7,539.8,1569,-297,1272,1,waiting,1
1,4,793.2,547,477,1299,1776,2,targOff,1
1,5,968.5,549.5,1455,-286,1169,1,waiting,1
1,5,785.2,541.1,482,1200,1682,2,targOff,1
1,6,964.2,539.5,1357,-288,1069,1,waiting,1
1,6,1161.1,550.6,361,1103,1464,2,targOff,1
1,7,966.1,539.5,1180,-54,1126,1,waiting,1
1,7,1065.6,544.9,39,1149,1188,2,waiting,1
1,7,1165.4,556.1,147,1213,1360,3,waiting,1
1,7,1131.8,553.1,513,1369,1882,4,targVis,1
1,8,962,546.9,1551,-286,1265,1,waiting,1
1,8,1123.6,548.7,468,1296,1764,2,targOff,1
1,9,958.6,548.4,1495,-273,1222,1,waiting,1
1,9,1148.1,555.1,474,1258,1732,2,targOff,1
1,10,965.3,553,1611,-282,1329,1,waiting,1
1,10,1147.9,551,484,1364,1848,2,targOff,1
1,11,964,548.9,1424,-285,1139,1,waiting,1
1,11,798.2,549.2,497,1168,1665,2,targOff,1
1,12,962.4,544.9,1620,-286,1334,1,waiting,1
1,12,1152.5,552,464,1367,1831,2,targOff,1
1,13,963,554.1,1315,-280,1035,1,waiting,1
1,13,1148,555.9,431,1065,1496,2,targOff,1
1,14,968,549.9,1193,-45,1148,1,waiting,1
1,14,1136.3,556.8,447,1179,1626,2,targOff,1
1,15,966,552.1,1325,-280,1045,1,waiting,1
1,15,789.4,546.9,467,1077,1544,2,targOff,1
1,16,965.3,550.2,1185,-125,1060,1,waiting,1
1,16,793.2,549.9,437,1093,1530,2,targOff,1
1,17,966.6,549.8,1214,-41,1173,1,waiting,1
1,17,801.2,550.9,463,1197,1660,2,targOff,1
1,18,963,552.1,1237,-54,1183,1,waiting,1
1,18,778.5,546.2,450,1214,1664,2,targOff,1
1,19,967.2,547.1,1079,-88,991,1,waiting,1
1,19,1128.8,546.4,423,1023,1446,2,targOff,1
1,20,952.8,545.3,434,-271,163,1,waiting,1
1,20,957.7,537.1,682,299,981,2,waiting,1
1,21,967.3,551.1,1500,-288,1212,1,waiting,1
1,21,786.6,553.9,487,1244,1731,2,targOff,1
1,22,964.3,549.3,1222,-116,1106,1,waiting,1
1,22,1133.1,554.6,440,1141,1581,2,targOff,1
1,23,954.6,558.2,1290,-41,1249,1,waiting,1
1,23,1090.6,556.5,268,1279,1547,2,targOff,1
1,23,1143,550.6,160,1565,1725,3,targOff,1
1,24,959.7,548,1402,-271,1131,1,waiting,1
1,24,1109.5,554.9,441,1157,1598,2,targOff,1
1,25,969.4,549.2,1199,-24,1175,1,waiting,1
1,25,1138.4,550.3,492,1201,1693,2,targOff,1
1,26,969.3,551.7,1159,-104,1055,1,waiting,1
1,26,808.3,551,463,1084,1547,2,targOff,1
1,27,969.8,547.4,1014,-7,1007,1,waiting,1
1,27,1133.1,553.5,464,1033,1497,2,targOff,1
1,28,969.8,544.1,1346,-272,1074,1,waiting,1
1,28,787.7,549.5,457,1107,1564,2,targOff,1
1,29,963.5,551.4,1263,-284,979,1,waiting,1
1,29,804.2,548.3,456,1008,1464,2,targOff,1
1,30,967,547.9,1381,-277,1104,1,waiting,1
1,30,791.2,547,466,1131,1597,2,targOff,1
1,31,962.9,548.8,1090,-16,1074,1,waiting,1
1,31,779,553,491,1106,1597,2,targOff,1
1,32,970.5,546,1459,-275,1184,1,waiting,1
1,32,1135.6,546.2,480,1214,1694,2,targOff,1
1,33,965.4,545.1,1246,-40,1206,1,waiting,1
1,33,801.3,547.6,478,1236,1714,2,targOff,1
1,34,952.9,545.6,182,-71,111,1,waiting,1
1,34,970.1,540.7,1002,121,1123,2,waiting,1
1,34,826.2,546.9,449,1148,1597,3,targOff,1
1,35,962.5,546,1082,-12,1070,1,waiting,1
1,35,1143.7,548.1,471,1104,1575,2,targOff,1
1,36,958.7,544,1074,-40,1034,1,waiting,1
1,36,802.6,540.6,466,1064,1530,2,targOff,1
1,37,962.2,546,1077,-63,1014,1,waiting,1
1,37,782.8,550.4,416,1046,1462,2,targOff,1
1,38,960.1,546,1264,-52,1212,1,waiting,1
1,38,784.6,545.4,505,1242,1747,2,targOff,1
1,39,962.6,546.6,1449,-280,1169,1,waiting,1
1,39,783.4,549.2,712,1201,1913,2,waiting,1
1,40,963.3,544.8,1523,-272,1251,1,waiting,1
1,40,1127.9,542.8,462,1285,1747,2,targOff,1
1,1,962.6,554.6,2174,-281,1893,1,waiting,2
1,2,957.4,548.8,2004,-277,1727,1,waiting,2
1,3,957,551.8,2084,-270,1814,1,waiting,2
1,4,968.9,539.4,1741,-281,1460,1,waiting,2
1,5,959.3,546.6,1923,-26,1897,1,waiting,2
1,6,958.2,552,2117,-203,1914,1,waiting,2
1,7,968.9,547.8,1879,-282,1597,1,waiting,2
1,8,961.1,551.5,2127,-280,1847,1,waiting,2
1,9,963.5,544.2,1946,-282,1664,1,waiting,2
1,10,962,550.7,773,-272,501,1,waiting,2
1,10,970,542.7,448,632,1080,2,waiting,2
1,11,969,563.2,2087,-273,1814,1,waiting,2
1,12,967.5,551.8,2017,-270,1747,1,waiting,2
1,13,952.9,560,285,-284,1,1,waiting,2
1,13,967.6,557,1789,9,1798,2,waiting,2
1,14,969.7,559.3,2199,-285,1914,1,waiting,2
1,15,959.6,514.6,124,-110,14,1,waiting,2
1,15,969.4,549,1633,31,1664,2,waiting,2
1,16,971.1,539.3,500,-280,220,1,waiting,2
1,16,967.9,552.1,1215,229,1444,2,waiting,2
1,17,963.5,561,1975,-279,1696,1,waiting,2
1,18,967.2,553.3,2170,-272,1898,1,waiting,2
1,19,972.3,544.6,2156,-280,1876,1,waiting,2
1,20,961.5,544.5,219,229,448,1,waiting,2
1,20,976.9,544.9,500,464,964,2,waiting,2
1,21,964.8,550.7,1930,-283,1647,1,waiting,2
1,22,972.5,553.8,1770,-22,1748,1,waiting,2
1,23,953.7,560.2,1873,-280,1593,1,waiting,2
1,24,963.9,553.5,1674,-27,1647,1,waiting,2
1,25,957.5,549.7,1766,-269,1497,1,waiting,2
1,26,967.7,552.7,2102,-271,1831,1,waiting,2
1,27,969.5,553.8,1860,-62,1798,1,waiting,2
1,28,956,554.2,1642,-12,1630,1,waiting,2
1,29,966.5,554.7,1683,-102,1581,1,waiting,2
1,30,971.7,513.3,136,-129,7,1,waiting,2
1,30,964.8,546.5,1507,23,1530,2,waiting,2
1,31,962.8,555.4,1739,-58,1681,1,waiting,2
1,32,969,545.3,2151,-271,1880,1,waiting,2
1,33,957.1,553.1,2048,-284,1764,1,waiting,2
1,34,965.5,575.2,105,-54,51,1,waiting,2
1,34,967.5,551,1695,69,1764,2,waiting,2
1,35,948,573.1,184,-64,120,1,waiting,2
1,35,963,553.9,1490,141,1631,2,waiting,2
1,36,962.1,548.7,1640,-42,1598,1,waiting,2
1,37,957.7,556.3,1949,-69,1880,1,waiting,2
1,38,968.9,552.7,2083,-286,1797,1,waiting,2
1,39,963.9,554.1,1678,-18,1660,1,waiting,2
1,40,952.4,563.1,1897,-283,1614,1,waiting,2
1,1,943.7,542.4,296,-274,22,1,waiting,3
1,1,963.5,554,1102,34,1136,2,waiting,3
1,1,1130.5,551.5,259,1171,1430,3,targOff,3
1,2,981.8,538.5,272,-270,2,1,waiting,3
1,2,964.5,555,1156,14,1170,2,waiting,3
1,2,796.2,551.5,682,1200,1882,3,dotOff,3
1,3,965.2,546.8,1309,-81,1228,1,waiting,3
1,3,789,553.7,571,1260,1831,2,dotOff,3
1,4,961,547.6,1655,-269,1386,1,waiting,3
1,4,1132.9,554.2,485,1412,1897,2,targOff,3
1,5,963.8,555.1,1304,-15,1289,1,waiting,3
1,5,1141.9,554.1,515,1315,1830,2,targVis,3
1,6,967.7,552.6,937,-38,899,1,waiting,3
1,6,1119.6,555,202,923,1125,2,targVis,3
1,6,1136.2,556.2,347,1133,1480,3,targOff,3
1,7,967.8,550.2,1323,-286,1037,1,waiting,3
1,7,1141.8,547.8,468,1062,1530,2,targOff,3
1,8,966.5,548.2,1014,-32,982,1,waiting,3
1,8,1118.1,553,287,1006,1293,2,waiting,3
1,8,1147.2,549.9,417,1314,1731,3,targOff,3
1,9,964.7,552.2,1439,-272,1167,1,waiting,3
1,9,789.9,541.5,487,1194,1681,2,targOff,3
1,10,962.7,541.8,1415,-270,1145,1,waiting,3
1,10,1104.1,544.3,275,1171,1446,2,waiting,3
1,10,1143.9,548.5,428,1469,1897,3,targOff,3
1,11,946.1,553.4,144,-134,10,1,waiting,3
1,11,964.1,556,1012,18,1030,2,waiting,3
1,11,1139.3,547.5,470,1057,1527,3,targOff,3
1,12,964.4,550.9,993,-22,971,1,waiting,3
1,12,788.4,554.4,475,1005,1480,2,targOff,3
1,13,991.1,543.7,251,-86,165,1,waiting,3
1,13,964.6,549.8,1116,174,1290,2,waiting,3
1,13,794.9,544.2,461,1315,1776,3,targOff,3
1,14,960.6,546.1,1121,-52,1069,1,waiting,3
1,14,1141.1,550.4,470,1095,1565,2,targOff,3
1,15,957.4,552.9,1437,-283,1154,1,waiting,3
1,15,1132.8,547,501,1179,1680,2,targOff,3
1,16,964.9,551.5,1415,-41,1374,1,waiting,3
1,16,1126.3,546.6,475,1405,1880,2,targOff,3
1,17,962.2,551.7,1562,-270,1292,1,waiting,3
1,17,1120.7,552.7,497,1318,1815,2,targOff,3
1,18,966.5,549.8,1364,-287,1077,1,waiting,3
1,18,807.5,543.1,494,1100,1594,2,targOff,3
1,19,965.7,548.7,1136,-10,1126,1,waiting,3
1,19,788.2,544.6,489,1158,1647,2,targOff,3
1,20,966,553,1040,-39,1001,1,waiting,3
1,20,1143.5,553.5,413,1035,1448,2,targOff,3
1,21,966.8,552.4,1220,-160,1060,1,waiting,3
1,21,811.1,549.4,435,1092,1527,2,targOff,3
1,22,967.2,547,1492,-278,1214,1,waiting,3
1,22,1126.5,551.8,489,1239,1728,2,targOff,3
1,23,964.7,549.9,1191,-36,1155,1,waiting,3
1,23,1134.7,549.3,480,1181,1661,2,targOff,3
1,24,965.3,548.1,1260,-17,1243,1,waiting,3
1,24,791,549,512,1268,1780,2,targOff,3
1,25,963.4,550.2,1323,-54,1269,1,waiting,3
1,25,799,552,482,1295,1777,2,targOff,3
1,26,965.6,553.4,1077,-73,1004,1,waiting,3
1,26,786.5,555.6,411,1036,1447,2,targOff,3
1,27,967.9,553.3,1532,-271,1261,1,waiting,3
1,27,1085.5,551.3,56,1283,1339,2,dotOff,3
1,27,1170.8,552.3,165,1373,1538,3,targVis,3
1,27,1144.1,553.9,350,1547,1897,4,targOff,3
1,28,960.8,558.9,1660,-283,1377,1,waiting,3
1,28,783.5,551.9,483,1410,1893,2,targOff,3
1,29,954.9,554,1359,-48,1311,1,waiting,3
1,29,800,553.8,495,1335,1830,2,targOff,3
1,30,965.9,546.4,1579,-280,1299,1,waiting,3
1,30,1132.7,555,571,1326,1897,2,dotOff,3
1,31,963.9,549,1708,-272,1436,1,waiting,3
1,31,787,552.1,453,1461,1914,2,targOff,3
1,32,964.2,540,1600,-286,1314,1,waiting,3
1,32,1140,545.4,481,1350,1831,2,targOff,3
1,33,963.4,548,1466,-286,1180,1,waiting,3
1,33,1136.7,547.7,507,1207,1714,2,targOff,3
1,34,965.5,551.7,1348,-274,1074,1,waiting,3
1,34,862.9,546.3,164,1094,1258,2,targOff,3
1,34,791.6,544.1,254,1277,1531,3,targOff,3
1,35,971.9,544.1,1621,-271,1350,1,waiting,3
1,35,788.4,544,463,1384,1847,2,targOff,3
1,36,962.4,546.8,1302,-271,1031,1,waiting,3
1,36,1121.7,551.1,440,1057,1497,2,targOff,3
1,37,964,554.7,1216,-32,1184,1,waiting,3
1,37,801.3,555.9,488,1210,1698,2,targOff,3
1,38,967.6,544.9,1095,-67,1028,1,waiting,3
1,38,798.6,554,422,1059,1481,2,targOff,3
1,39,969,544.3,1336,-285,1051,1,waiting,3
1,39,1144.8,547.8,470,1077,1547,2,targOff,3
1,40,961.4,557,1606,-279,1327,1,waiting,3
1,40,1118.1,552.8,490,1352,1842,2,targOff,3
1,1,958.4,547.6,1810,-283,1527,1,waiting,4
1,2,965,545.5,1841,-279,1562,1,waiting,4
1,3,957.5,551,2115,-285,1830,1,waiting,4
1,4,959.1,543.6,2001,-270,1731,1,waiting,4
1,5,964.1,545.3,1659,-62,1597,1,waiting,4
1,6,962.9,547.8,2017,-270,1747,1,waiting,4
1,7,956,549.3,1811,-36,1775,1,waiting,4
1,8,962.6,556.4,1844,-281,1563,1,waiting,4
1,9,967.7,558.2,2131,-284,1847,1,waiting,4
1,10,964,550.1,2127,-284,1843,1,waiting,4
1,11,959.5,556.3,1811,-280,1531,1,waiting,4
1,12,964.9,545.4,1747,-283,1464,1,waiting,4
1,13,966.3,547.7,1495,-17,1478,1,waiting,4
1,14,959.8,546.3,1861,-281,1580,1,waiting,4
1,15,960.7,549.9,1707,-26,1681,1,waiting,4
1,16,961.4,542,1631,1,1632,1,waiting,4
1,17,964.9,536.1,2064,-283,1781,1,waiting,4
1,18,961.3,551.7,2186,-273,1913,1,waiting,4
1,19,963.9,537.5,1843,-283,1560,1,waiting,4
1,20,956.2,551.6,2055,-174,1881,1,waiting,4
1,21,956.1,556.7,1917,-36,1881,1,waiting,4
1,22,961.2,553.7,1858,-279,1579,1,waiting,4
1,23,963.7,547.4,1912,-281,1631,1,waiting,4
1,24,963.9,551.6,1763,-32,1731,1,waiting,4
1,25,961.5,547.8,1584,-36,1548,1,waiting,4
1,26,959.8,549,1891,-44,1847,1,waiting,4
1,27,969.1,550.7,2022,-278,1744,1,waiting,4
1,28,974.7,542,1976,-281,1695,1,waiting,4
1,29,966.9,551.7,1632,-35,1597,1,waiting,4
1,30,975.1,556.1,1894,-80,1814,1,waiting,4
1,31,968.2,556.4,1905,-8,1897,1,waiting,4
1,32,962.3,553.2,2145,-281,1864,1,waiting,4
1,33,966.8,554.8,1900,-286,1614,1,waiting,4
1,34,954.7,550.5,303,-272,31,1,waiting,4
1,34,968.7,550.9,1563,51,1614,2,waiting,4
1,35,947.7,572.7,314,-282,32,1,waiting,4
1,35,969.5,556.1,1524,54,1578,2,waiting,4
1,36,968.2,546.8,1521,-26,1495,1,waiting,4
1,37,949,565.5,120,-53,67,1,waiting,4
1,37,968.1,549.2,1601,79,1680,2,waiting,4
1,38,961.2,547.5,1825,-30,1795,1,waiting,4
1,39,957.7,540.6,1877,-47,1830,1,waiting,4
1,40,962.3,545.1,2059,-279,1780,1,waiting,4
1,1,905.6,545.9,170,-114,56,1,waiting,5
1,1,970.5,550.3,1134,75,1209,2,waiting,5
1,1,1089.8,551.2,224,1233,1457,3,targOff,5
1,1,1140.1,548.3,156,1475,1631,4,targOff,5
1,2,945.2,614,120,5,125,1,waiting,5
1,2,982.3,561.5,124,158,282,2,waiting,5
1,2,963.4,552.3,1101,298,1399,3,waiting,5
1,2,783.4,542.5,465,1432,1897,4,targOff,5
1,3,954.4,543.4,1203,-279,924,1,waiting,5
1,3,865.3,544.2,181,946,1127,2,dotOff,5
1,3,802.9,542.5,419,1144,1563,3,targOff,5
1,4,967,539.3,1469,-280,1189,1,waiting,5
1,4,1146.8,551.3,609,1222,1831,2,dotOff,5
1,5,960.7,539,1037,-55,982,1,waiting,5
1,5,794.5,544.4,474,1007,1481,2,targOff,5
1,6,968.1,537.5,1236,-75,1161,1,waiting,5
1,6,1134.7,545.8,683,1194,1877,2,waiting,5
1,7,968.4,543.2,1246,-269,977,1,waiting,5
1,7,1110.7,543.7,302,1001,1303,2,waiting,5
1,7,1134.3,544,453,1322,1775,3,targOff,5
1,7,1053.4,558.6,37,1794,1831,4,targOff,5
1,8,960.3,538.3,110,7,117,1,waiting,5
1,8,965.5,544.1,1215,125,1340,2,waiting,5
1,8,1145.7,544.3,469,1375,1844,3,targOff,5
1,9,961.5,546.9,1396,-23,1373,1,waiting,5
1,9,793,545.8,496,1399,1895,2,targOff,5
1,10,965.5,541.3,1467,-279,1188,1,waiting,5
1,10,1141.3,543.2,480,1215,1695,2,targOff,5
1,11,961.7,536.8,1339,-275,1064,1,waiting,5
1,11,1134.3,547.7,451,1096,1547,2,targOff,5
1,12,960,540.5,1578,-273,1305,1,waiting,5
1,12,780.2,549.6,450,1331,1781,2,targOff,5
1,13,970,543.3,1283,-281,1002,1,waiting,5
1,13,788,542.4,464,1033,1497,2,targOff,5
1,14,964.5,546.4,1659,-285,1374,1,waiting,5
1,14,778,548.7,473,1407,1880,2,targOff,5
1,15,962.4,543.6,1197,-79,1118,1,waiting,5
1,15,1136,544.4,429,1151,1580,2,targOff,5
1,16,969.5,592,158,346,504,1,waiting,5
1,16,980,539.3,137,525,662,2,waiting,5
1,16,959.4,546.8,494,670,1164,3,waiting,5
1,17,967.2,544.5,1453,-275,1178,1,waiting,5
1,17,1149.3,542.6,639,1205,1844,2,dotOff,5
1,18,969.1,550.2,1197,-41,1156,1,waiting,5
1,18,790.2,546.4,466,1182,1648,2,targOff,5
1,19,959.6,540.3,1433,-271,1162,1,waiting,5
1,19,1108.2,545.7,402,1189,1591,2,targOff,5
1,19,1142,545.3,61,1604,1665,3,targOff,5
1,20,963.2,545.7,1684,-282,1402,1,waiting,5
1,20,1128.3,539.3,471,1427,1898,2,targOff,5
1,21,960.7,554.4,1046,-55,991,1,waiting,5
1,21,1105.1,556.3,430,1017,1447,2,targOff,5
1,22,965,550.2,1160,-10,1150,1,waiting,5
1,22,808.2,549.1,331,1175,1506,2,targOff,5
1,22,772.8,550.9,130,1517,1647,3,targOff,5
1,23,957.9,546.1,1513,-271,1242,1,waiting,5
1,23,1134.7,547.7,496,1268,1764,2,targOff,5
1,24,948,461.8,153,-96,57,1,waiting,5
1,24,972.1,557.5,120,90,210,2,waiting,5
1,24,963.1,540.1,816,227,1043,3,waiting,5
1,24,774.1,548.9,355,1076,1431,4,targOff,5
1,25,963.4,547.4,1018,-42,976,1,waiting,5
1,25,1097.2,547,171,1000,1171,2,waiting,5
1,25,1144.6,547.4,478,1186,1664,3,targOff,5
1,26,960.1,553.6,951,9,960,1,waiting,5
1,26,786.3,552.8,441,989,1430,2,targOff,5
1,27,966.9,539.6,1101,-28,1073,1,waiting,5
1,27,1150.5,545.5,472,1109,1581,2,targOff,5
1,28,964.2,548.1,1098,1,1099,1,waiting,5
1,28,787.4,547.7,489,1125,1614,2,targOff,5
1,29,968.6,542.3,1641,-278,1363,1,waiting,5
1,29,1111,545.3,187,1388,1575,2,targVis,5
1,29,1126.6,547.2,342,1585,1927,3,targOff,5
1,30,965.3,546.6,1322,-278,1044,1,waiting,5
1,30,791.3,539.4,498,1076,1574,2,targVis,5
1,31,965,542.5,1387,-273,1114,1,waiting,5
1,31,1142.1,545.8,491,1140,1631,2,targOff,5
1,32,964.7,556.4,1634,-282,1352,1,waiting,5
1,32,1148.5,550.8,441,1387,1828,2,targOff,5
1,33,964.4,548,1464,-284,1180,1,waiting,5
1,33,1128.3,548.7,449,1215,1664,2,targOff,5
1,34,961,546.1,1506,-286,1220,1,waiting,5
1,34,790.3,541.3,599,1245,1844,2,dotOff,5
1,35,956.7,544.5,1474,-225,1249,1,waiting,5
1,35,1118.6,547.5,440,1274,1714,2,targOff,5
1,36,967.2,544.2,1414,-16,1398,1,waiting,5
1,36,777.1,548,463,1435,1898,2,targOff,5
1,37,960.3,549.6,1163,-48,1115,1,waiting,5
1,37,792.6,547.9,453,1140,1593,2,targOff,5
1,38,963,542,1022,4,1026,1,waiting,5
1,38,1103,546.6,181,1056,1237,2,dotOff,5
1,38,1136.8,542.3,457,1257,1714,3,targOff,5
1,39,966.2,544.6,830,-6,824,1,waiting,5
1,39,781.3,556.2,382,849,1231,2,waiting,5
1,40,969.1,545.4,1434,-279,1155,1,waiting,5
1,40,796.5,553.3,444,1187,1631,2,targOff,5
1,1,961,561.2,1821,-278,1543,1,waiting,6
1,1,976.2,546.9,94,1685,1779,2,targOff,6
1,2,961.5,550.8,2179,-281,1898,1,waiting,6
1,3,960.7,556.7,1990,-275,1715,1,waiting,6
1,4,965.1,555.6,1899,-285,1614,1,waiting,6
1,5,971.9,555.3,1797,-49,1748,1,waiting,6
1,6,964.5,559.7,1650,-53,1597,1,waiting,6
1,7,966.5,556.3,1832,-285,1547,1,waiting,6
1,8,968.4,554.8,1845,-281,1564,1,waiting,6
1,9,970.7,552.7,2186,-271,1915,1,waiting,6
1,10,973.1,550.3,1996,-282,1714,1,waiting,6
1,11,963.9,550.1,1759,-278,1481,1,waiting,6
1,12,968.8,550.8,2140,-279,1861,1,waiting,6
1,13,974.5,553,1883,-269,1614,1,waiting,6
1,14,972.3,549.7,1766,-286,1480,1,waiting,6
1,15,964.6,561.7,1644,-197,1447,1,waiting,6
1,16,976,548.4,1908,-280,1628,1,waiting,6
1,17,969.3,547.8,1863,2,1865,1,waiting,6
1,18,969.8,550,1751,-271,1480,1,waiting,6
1,19,973.5,544.3,1678,-48,1630,1,waiting,6
1,20,971.9,543.1,1748,-284,1464,1,waiting,6
1,21,972.5,554.8,1861,-280,1581,1,waiting,6
1,22,969.7,554,1781,-37,1744,1,waiting,6
1,23,971.2,549.9,1664,-33,1631,1,waiting,6
1,24,979,550,1849,-285,1564,1,waiting,6
1,25,1005.4,507.5,182,-153,29,1,waiting,6
1,25,972.5,546,1813,51,1864,2,waiting,6
1,26,975.1,547.6,2181,-283,1898,1,waiting,6
1,27,975.8,546.6,1636,-41,1595,1,waiting,6
1,28,974,549.1,1649,-169,1480,1,waiting,6
1,29,972.6,551.1,1695,-14,1681,1,waiting,6
1,30,969,548.8,1728,-281,1447,1,waiting,6
1,31,977.9,551.1,1925,-77,1848,1,waiting,6
1,32,971.7,553.1,2111,-280,1831,1,waiting,6
1,33,968,550.9,1933,-269,1664,1,waiting,6
1,34,974.9,543.6,1539,-25,1514,1,waiting,6
1,35,961.5,556.8,2018,-271,1747,1,waiting,6
1,36,967.9,552.3,1687,-40,1647,1,waiting,6
1,37,972.9,555.4,1754,-285,1469,1,waiting,6
1,38,963.9,543,1767,-22,1745,1,waiting,6
1,39,963.7,550,1681,1,1682,1,waiting,6
1,40,962,558.7,1855,-279,1576,1,waiting,6
1,1,976.5,540.2,1686,-138,1548,1,waiting,7
1,2,979.8,549,1581,-281,1300,1,waiting,7
1,2,1148.8,554,576,1335,1911,2,dotOff,7
1,3,969.3,553.2,1330,-281,1049,1,waiting,7
1,3,1141.5,558.8,415,1080,1495,2,targOff,7
1,4,968.6,540,1671,-241,1430,1,waiting,7
1,4,1109.6,559.2,405,1455,1860,2,targOff,7
1,5,969.1,556.2,1478,-279,1199,1,waiting,7
1,5,1106.8,553.8,405,1222,1627,2,targOff,7
1,6,968.4,555,1413,-278,1135,1,waiting,7
1,6,1125.5,555.9,413,1164,1577,2,targOff,7
1,7,969.9,545.1,1414,-280,1134,1,waiting,7
1,7,792.1,551.2,431,1164,1595,2,targOff,7
1,8,963.3,544.2,1424,-284,1140,1,waiting,7
1,8,797.3,550,424,1169,1593,2,targOff,7
1,9,968.5,546.6,1329,-53,1276,1,waiting,7
1,9,804.4,541,480,1301,1781,2,targOff,7
1,10,971.3,549.3,1226,-280,946,1,waiting,7
1,10,1140.4,548.4,825,972,1797,2,waiting,7
1,11,964,546,1257,-141,1116,1,waiting,7
1,11,802.4,544.5,433,1148,1581,2,targOff,7
1,12,968,537.9,1000,-39,961,1,waiting,7
1,12,1136.6,546.7,438,993,1431,2,targOff,7
1,13,971.2,550.8,1136,-269,867,1,waiting,7
1,13,782.9,551.7,668,896,1564,2,waiting,7
1,14,972.9,545.5,1284,-280,1004,1,waiting,7
1,14,795.5,544.5,483,1030,1513,2,targOff,7
1,15,974.7,544.8,1406,-44,1362,1,waiting,7
1,15,788,550.9,485,1396,1881,2,targOff,7
1,16,973,551,1078,-31,1047,1,waiting,7
1,16,1153.5,553,432,1082,1514,2,targOff,7
1,17,974.1,547.5,1105,-75,1030,1,waiting,7
1,17,1131.7,550.1,437,1060,1497,2,targOff,7
1,18,968.7,557.7,1550,-283,1267,1,waiting,7
1,18,1151.7,554.6,487,1293,1780,2,targOff,7
1,19,969.6,549.1,1585,-277,1308,1,waiting,7
1,19,779,568.4,490,1341,1831,2,targOff,7
1,20,975.1,546.9,1061,-10,1051,1,waiting,7
1,20,794,553,437,1077,1514,2,targOff,7
1,21,963.9,543.2,1040,-3,1037,1,waiting,7
1,21,780.8,553.3,462,1064,1526,2,targOff,7
1,22,961.3,556.2,1331,-279,1052,1,waiting,7
1,22,784.8,543,470,1078,1548,2,targOff,7
1,23,968.2,543.8,1538,-273,1265,1,waiting,7
1,23,1087.2,559.2,182,1288,1470,2,dotOff,7
1,23,1152.3,557.1,420,1494,1914,3,targOff,7
1,24,985.8,534.2,293,-269,24,1,waiting,7
1,24,975.4,546.7,1283,35,1318,2,waiting,7
1,24,1139.9,552.2,485,1345,1830,3,targOff,7
1,25,968.3,549.1,1250,-285,965,1,waiting,7
1,25,794.6,544.9,434,994,1428,2,targOff,7
1,26,972.1,547.6,1071,-9,1062,1,waiting,7
1,26,1157.9,547.9,452,1095,1547,2,targOff,7
1,27,970.3,540.8,1511,-223,1288,1,waiting,7
1,27,786.5,545.3,478,1319,1797,2,targOff,7
1,28,972.2,549.4,1317,-35,1282,1,waiting,7
1,28,1161.6,543.5,514,1316,1830,2,targVis,7
1,29,978.3,545.2,1453,-269,1184,1,waiting,7
1,29,778.3,552,503,1211,1714,2,targOff,7
1,30,972.9,546.7,1610,-280,1330,1,waiting,7
1,30,811.3,554.8,439,1357,1796,2,targOff,7
1,31,977.9,552.6,1340,-276,1064,1,waiting,7
1,31,795.2,554.8,466,1098,1564,2,targOff,7
1,32,978.6,550.7,1321,-273,1048,1,waiting,7
1,32,1147.5,555.2,422,1075,1497,2,targOff,7
1,33,970.2,546.3,1510,-284,1226,1,waiting,7
1,33,804.4,560.3,453,1257,1710,2,targOff,7
1,34,971.1,548.5,784,-60,724,1,waiting,7
1,34,792.4,544.7,476,755,1231,2,waiting,7
1,35,985.1,553.9,1228,-281,947,1,waiting,7
1,35,807.9,554.2,483,976,1459,2,targOff,7
1,36,956.6,540.3,126,-90,36,1,waiting,7
1,36,974.1,546.1,1360,44,1404,2,waiting,7
1,36,1140.7,559.1,462,1435,1897,3,targOff,7
1,37,972.2,541.9,1269,-46,1223,1,waiting,7
1,37,796.5,552.7,340,1254,1594,2,targOff,7
1,37,784,540.2,123,1603,1726,3,targOff,7
1,38,964.5,554.8,1388,-34,1354,1,waiting,7
1,38,1167.5,558.4,476,1388,1864,2,targOff,7
1,39,968.6,545.2,1217,-11,1206,1,waiting,7
1,39,1151.5,548.9,470,1244,1714,2,targOff,7
1,40,970.3,547.7,1682,-273,1409,1,waiting,7
1,40,1153.2,550.8,461,1436,1897,2,targOff,7
1,1,974.7,542.6,1927,-113,1814,1,waiting,8
1,2,958.7,554.1,1804,-274,1530,1,waiting,8
1,3,964.1,555,1707,-276,1431,1,waiting,8
1,4,967.7,546.7,2012,-282,1730,1,waiting,8
1,5,968.9,548.1,1570,-56,1514,1,waiting,8
1,6,972.2,542.7,2146,-283,1863,1,waiting,8
1,7,966.1,554.8,1554,-60,1494,1,waiting,8
1,8,973,548.3,1733,-36,1697,1,waiting,8
1,9,978.9,572.3,115,-108,7,1,waiting,8
1,9,976.5,549.1,1541,23,1564,2,waiting,8
1,10,969.9,551.6,1856,-275,1581,1,waiting,8
1,11,1016.1,721,77,913,990,1,waiting,8
1,11,1041.3,580.3,91,1020,1111,2,waiting,8
1,11,985.5,547.1,95,1136,1231,3,waiting,8
1,12,971.6,553.2,1614,-166,1448,1,waiting,8
1,13,963.4,557.3,1983,-74,1909,1,waiting,8
1,14,976.6,551.9,2126,-278,1848,1,waiting,8
1,15,978.8,555,2120,-272,1848,1,waiting,8
1,16,967.6,550.2,2015,-285,1730,1,waiting,8
1,17,977,550.6,1655,-111,1544,1,waiting,8
1,18,973.4,547.7,1723,-278,1445,1,waiting,8
1,19,971.4,553.3,1983,-270,1713,1,waiting,8
1,20,976.2,553.8,2061,-281,1780,1,waiting,8
1,21,975.2,550.3,1798,-18,1780,1,waiting,8
1,22,974.9,553,1504,-24,1480,1,waiting,8
1,23,975.7,551.2,1974,-281,1693,1,waiting,8
1,24,976.5,553.7,1875,-280,1595,1,waiting,8
1,25,971.5,549.7,1807,-276,1531,1,waiting,8
1,26,975,552.9,1621,-24,1597,1,waiting,8
1,27,969.7,547.2,1742,-279,1463,1,waiting,8
1,28,980.3,548.1,1731,-284,1447,1,waiting,8
1,29,974,549.3,1543,-12,1531,1,waiting,8
1,30,967,547.5,1716,-57,1659,1,waiting,8
1,31,978.3,550.2,1907,-27,1880,1,waiting,8
1,32,971.9,554.5,2020,-273,1747,1,waiting,8
1,33,981.9,547,1909,-279,1630,1,waiting,8
1,34,969.6,553.7,1992,-279,1713,1,waiting,8
1,35,986,545.3,1761,-280,1481,1,waiting,8
1,36,979,547.3,2128,-280,1848,1,waiting,8
1,37,973.6,549.9,1546,-33,1513,1,waiting,8
1,38,977.8,549.4,1878,-281,1597,1,waiting,8
1,39,978.8,548.1,1984,-103,1881,1,waiting,8
1,40,965.6,551.5,1850,-36,1814,1,waiting,8
1,1,966,542.9,1349,14,1363,1,waiting,9
1,1,1147.9,545.7,479,1401,1880,2,targOff,9
1,2,977,552.7,1340,-272,1068,1,waiting,9
1,2,780.6,553.4,379,1101,1480,2,targOff,9
1,3,963.4,563,1113,-40,1073,1,waiting,9
1,3,776.9,558.8,490,1107,1597,2,targOff,9
1,4,968.7,543.3,485,-280,205,1,waiting,9
1,4,976.3,556.6,979,213,1192,2,waiting,9
1,4,784.3,542.7,621,1224,1845,3,dotOff,9
1,5,972.3,552.9,1241,-32,1209,1,waiting,9
1,5,1144.5,543.6,436,1245,1681,2,targOff,9
1,6,971,555.5,1624,-282,1342,1,waiting,9
1,6,1136,552.9,473,1373,1846,2,targOff,9
1,7,971.1,549.3,1197,-90,1107,1,waiting,9
1,7,813.6,547.7,251,1132,1383,2,targOff,9
1,7,770.6,544.6,165,1399,1564,3,targOff,9
1,8,969.6,553.5,1692,-285,1407,1,waiting,9
1,8,785.8,544.2,469,1440,1909,2,targOff,9
1,9,970.6,553.6,1545,-278,1267,1,waiting,9
1,9,796.5,556.5,463,1297,1760,2,targOff,9
1,10,971.5,546.7,1515,-282,1233,1,waiting,9
1,10,805.3,554.1,445,1264,1709,2,targOff,9
1,11,968.9,553.8,1365,-50,1315,1,waiting,9
1,11,1120.3,548.1,440,1341,1781,2,targOff,9
1,12,973.1,552,1114,-16,1098,1,waiting,9
1,12,1123.9,548.4,474,1123,1597,2,targOff,9
1,13,966.2,553.8,1315,-282,1033,1,waiting,9
1,13,1140.4,548.6,464,1068,1532,2,targOff,9
1,14,977.2,541.9,1250,-278,972,1,waiting,9
1,14,1144.8,539.9,716,998,1714,2,waiting,9
1,15,973.6,550.2,1573,-280,1293,1,waiting,9
1,15,802.7,545.3,475,1320,1795,2,targOff,9
1,16,1004.9,533,231,-192,39,1,waiting,9
1,16,972.6,543,1020,51,1071,2,waiting,9
1,16,1142.9,548,456,1108,1564,3,targOff,9
1,17,972.9,552.6,1162,-47,1115,1,waiting,9
1,17,1145.1,550.7,469,1145,1614,2,targOff,9
1,18,971.3,539.2,1073,-46,1027,1,waiting,9
1,18,783.4,541.6,455,1060,1515,2,targOff,9
1,19,968.9,543.2,1381,-284,1097,1,waiting,9
1,19,1140.1,545.1,483,1131,1614,2,targOff,9
1,20,973.9,543.6,1415,-274,1141,1,waiting,9
1,20,1133.8,547.9,696,1168,1864,2,waiting,9
1,21,961.7,549.6,1603,-272,1331,1,waiting,9
1,21,807.6,549.7,474,1356,1830,2,targOff,9
1,22,970.3,544.8,1522,-270,1252,1,waiting,9
1,22,784.6,543.7,463,1285,1748,2,targOff,9
1,23,969.7,554.4,1541,-280,1261,1,waiting,9
1,23,1129.3,540.9,493,1285,1778,2,targOff,9
1,24,969.3,538.9,1557,-281,1276,1,waiting,9
1,24,795.3,546.6,472,1309,1781,2,targOff,9
1,25,975.5,544.2,1296,-47,1249,1,waiting,9
1,25,788.6,543.1,468,1280,1748,2,targOff,9
1,26,972.7,546,1316,-58,1258,1,waiting,9
1,26,782.5,544.1,452,1296,1748,2,targOff,9
1,27,972.9,544.7,1379,-104,1275,1,waiting,9
1,27,1150.4,548.1,496,1301,1797,2,targOff,9
1,28,971.2,539.5,1189,-22,1167,1,waiting,9
1,28,1149.5,547,504,1193,1697,2,targOff,9
1,29,909.1,628.2,95,97,192,1,waiting,9
1,29,950.6,539.6,128,228,356,2,waiting,9
1,29,970.2,545.6,739,375,1114,3,waiting,9
1,30,974,543.4,1282,-278,1004,1,waiting,9
1,30,812.9,543.6,428,1033,1461,2,targOff,9
1,31,977.5,541.5,1506,-279,1227,1,waiting,9
1,31,791.4,545.9,465,1262,1727,2,targOff,9
1,32,968.6,554,1398,-153,1245,1,waiting,9
1,32,797,550.5,471,1276,1747,2,targOff,9
1,33,976,550.3,1379,-281,1098,1,waiting,9
1,33,1162.4,551.5,494,1132,1626,2,targOff,9
1,34,974.4,550.9,1511,-280,1231,1,waiting,9
1,34,1136.1,547.3,467,1263,1730,2,targOff,9
1,35,973.5,547,1015,-4,1011,1,waiting,9
1,35,806.4,545,428,1036,1464,2,targOff,9
1,36,967.5,547.5,1472,-285,1187,1,waiting,9
1,36,1138.3,546.5,482,1215,1697,2,targOff,9
1,37,965.7,550,1413,-271,1142,1,waiting,9
1,37,773.2,551.4,623,1175,1798,2,dotOff,9
1,38,972.7,541.2,1671,-279,1392,1,waiting,9
1,38,1147,546.3,487,1427,1914,2,targOff,9
1,39,970.1,550.4,1282,-286,996,1,waiting,9
1,39,1120.2,549.4,433,1031,1464,2,targOff,9
1,40,965.8,542.3,1308,-280,1028,1,waiting,9
1,40,1136.2,544.1,778,1063,1841,2,waiting,9
1,1,968.5,546,1875,6,1881,1,waiting,10
1,2,975.4,540.9,1810,-279,1531,1,waiting,10
1,3,972.7,547.1,1739,-280,1459,1,waiting,10
1,4,967.8,542.1,1822,-41,1781,1,waiting,10
1,5,965.1,546.7,2177,-279,1898,1,waiting,10
1,6,972.9,538.6,1922,-7,1915,1,waiting,10
1,7,983.1,543,294,-285,9,1,waiting,10
1,7,958.7,548.7,1430,17,1447,2,waiting,10
1,8,971.6,543.6,1733,-18,1715,1,waiting,10
1,9,967,542.9,1939,-25,1914,1,waiting,10
1,10,968.2,546.4,2066,-286,1780,1,waiting,10
1,11,970.4,545,1745,-283,1462,1,waiting,10
1,12,975.8,531,171,-36,135,1,waiting,10
1,13,964.4,546.4,2113,-282,1831,1,waiting,10
1,14,907,589.1,154,201,355,1,waiting,10
1,14,930.6,553.6,125,379,504,2,waiting,10
1,14,962.3,546.8,462,516,978,3,waiting,10
1,15,964.6,552.5,2188,-274,1914,1,waiting,10
1,16,962.3,547.2,1864,-283,1581,1,waiting,10
1,17,964.5,550.3,2096,-284,1812,1,waiting,10
1,18,969.1,548.5,1913,-33,1880,1,waiting,10
1,19,955.7,542.6,207,-35,172,1,waiting,10
1,19,960.2,543.6,1360,183,1543,2,waiting,10
1,20,958.8,544.1,1444,4,1448,1,waiting,10
1,21,971.9,552.4,1874,-280,1594,1,waiting,10
1,22,963.1,543.6,1911,-14,1897,1,waiting,10
1,23,969.5,553.3,1708,-277,1431,1,waiting,10
1,24,955.8,545.2,1531,-34,1497,1,waiting,10
1,25,972.1,532.4,1850,-224,1626,1,waiting,10
1,26,970.2,542.3,1729,-282,1447,1,waiting,10
1,27,968.8,541.9,2026,-278,1748,1,waiting,10
1,28,962.4,544.9,1924,-280,1644,1,waiting,10
1,29,961.7,550.3,1858,-281,1577,1,waiting,10
1,30,967.6,540.9,1850,-4,1846,1,waiting,10
1,31,964.5,544,1715,-184,1531,1,waiting,10
1,32,971.6,543.6,1496,-48,1448,1,waiting,10
1,33,967.7,553.4,289,-289,0,1,waiting,10
1,33,975.6,552.5,1506,8,1514,2,waiting,10
1,34,966.5,547,2104,-274,1830,1,waiting,10
1,35,964.2,538.4,1691,-277,1414,1,waiting,10
1,36,966.4,551,1933,-69,1864,1,waiting,10
1,37,967.8,546.5,1542,5,1547,1,waiting,10
1,38,966.3,547.1,1852,-272,1580,1,waiting,10
1,39,966.7,541.1,1602,-121,1481,1,waiting,10
1,40,974.5,546,1545,2,1547,1,waiting,10
1,1,971.5,534.1,1143,-13,1130,1,waiting,11
1,1,783.2,536.6,466,1165,1631,2,targOff,11
1,2,962.6,540.1,1204,-88,1116,1,waiting,11
1,2,785,538.6,700,1143,1843,2,waiting,11
1,3,957.1,551.4,1064,-8,1056,1,waiting,11
1,3,785.2,542,477,1087,1564,2,targOff,11
1,4,960.7,537.8,1336,-277,1059,1,waiting,11
1,4,1121.4,537.7,457,1090,1547,2,targOff,11
1,5,968.8,542.6,1280,-276,1004,1,waiting,11
1,5,1086.8,539.7,53,1027,1080,2,dotOff,11
1,5,1156,541.4,131,1113,1244,3,targVis,11
1,5,1132.1,541.2,378,1252,1630,4,targOff,11
1,6,961.4,545.6,1327,-281,1046,1,waiting,11
1,6,1088.1,546.7,334,1070,1404,2,waiting,11
1,6,1145.9,545.7,429,1422,1851,3,targOff,11
1,6,1047.2,546.3,38,1872,1910,4,targOff,11
1,7,958.8,540.8,1633,-282,1351,1,waiting,11
1,7,787,542.7,450,1380,1830,2,targOff,11
1,8,951.4,545.6,1142,-20,1122,1,waiting,11
1,8,768.4,543.8,476,1155,1631,2,targOff,11
1,9,957.4,546,1667,-277,1390,1,waiting,11
1,9,1124.6,543,463,1417,1880,2,targOff,11
1,10,961.9,546.6,1523,-279,1244,1,waiting,11
1,10,812.2,538.9,446,1268,1714,2,targOff,11
1,11,968.6,540.1,1300,-279,1021,1,waiting,11
1,11,802.6,537,417,1046,1463,2,targOff,11
1,12,966.5,544.6,1541,-275,1266,1,waiting,11
1,12,1133.3,541.1,450,1298,1748,2,targOff,11
1,13,952.2,551.4,1517,-281,1236,1,waiting,11
1,13,787.7,545.4,604,1260,1864,2,dotOff,11
1,14,961.9,548.4,1351,-275,1076,1,waiting,11
1,14,1091.7,547.9,281,1101,1382,2,targOff,11
1,14,1139.8,544.4,117,1397,1514,3,targOff,11
1,15,954.2,568.2,140,-80,60,1,waiting,11
1,15,955.6,550.2,975,69,1044,2,waiting,11
1,15,1106.2,544.5,363,1069,1432,3,targOff,11
1,15,1148.5,538.7,61,1452,1513,4,targOff,11
1,16,969.3,554.1,1876,-283,1593,1,waiting,11
1,16,1035.5,544.4,68,1612,1680,2,targOff,11
1,17,946.8,543.7,180,-158,22,1,waiting,11
1,17,963.5,560.4,1701,30,1731,2,waiting,11
1,18,963.6,554.9,1406,-15,1391,1,waiting,11
1,18,782.5,559.1,230,1417,1647,2,targOff,11
1,19,963.2,558.2,1262,-275,987,1,waiting,11
1,19,787.3,553.6,462,1019,1481,2,targOff,11
1,20,947.4,580,296,-279,17,1,waiting,11
1,20,962.6,556,1053,29,1082,2,waiting,11
1,20,1112.4,556.2,796,1117,1913,3,waiting,11
1,21,959.5,562.2,1295,-287,1008,1,waiting,11
1,21,1119.2,561.5,447,1034,1481,2,targOff,11
1,22,961.5,555.6,1177,-133,1044,1,waiting,11
1,22,1139.5,555.3,482,1081,1563,2,targOff,11
1,23,958.6,560.1,1205,-68,1137,1,waiting,11
1,23,1115.2,555.8,490,1174,1664,2,targOff,11
1,24,958.7,553.5,1498,-276,1222,1,waiting,11
1,24,1138.6,554.8,504,1259,1763,2,targOff,11
1,25,955.4,555.2,1213,-48,1165,1,waiting,11
1,25,786.9,555.1,473,1191,1664,2,targOff,11
1,26,958.5,552.4,1374,-287,1087,1,waiting,11
1,26,1144.4,567.5,553,1128,1681,2,targVis,11
1,27,963.9,550.6,1415,-277,1138,1,waiting,11
1,27,789.2,558.4,465,1166,1631,2,targOff,11
1,28,961.1,558,1188,-59,1129,1,waiting,11
1,28,1153.1,565.5,469,1162,1631,2,targOff,11
1,29,949.6,560.7,1379,-72,1307,1,waiting,11
1,29,800,566.9,467,1331,1798,2,targOff,11
1,30,961.3,564,1342,-274,1068,1,waiting,11
1,30,1132.6,562.7,448,1101,1549,2,targOff,11
1,31,955.3,550.1,1052,-14,1038,1,waiting,11
1,31,796.9,561.1,429,1068,1497,2,targOff,11
1,32,957.2,552.9,1442,-278,1164,1,waiting,11
1,32,782.1,558.3,483,1197,1680,2,targOff,11
1,33,962.6,555.3,1287,-61,1226,1,waiting,11
1,33,1138.8,558.3,492,1253,1745,2,targOff,11
1,34,951,555.1,1499,-284,1215,1,waiting,11
1,34,1053,559.5,60,1237,1297,2,targVis,11
1,34,1133.8,557.8,460,1321,1781,3,targOff,11
1,35,954.1,542.8,1365,-285,1080,1,waiting,11
1,35,1120.1,545.6,575,1105,1680,2,dotOff,11
1,36,969.3,537.4,503,-281,222,1,waiting,11
1,36,966.6,552.7,844,233,1077,2,waiting,11
1,36,805.1,555.8,461,1103,1564,3,targOff,11
1,37,962.1,555.4,1296,-277,1019,1,waiting,11
1,37,1137.6,557.9,484,1046,1530,2,targOff,11
1,38,952.3,551,1480,-287,1193,1,waiting,11
1,38,795.3,554.2,461,1219,1680,2,targOff,11
1,39,963,553,1278,-103,1175,1,waiting,11
1,39,1133.1,547.2,676,1201,1877,2,waiting,11
1,40,965.8,550.6,1464,-281,1183,1,waiting,11
1,40,1133.2,549.9,580,1218,1798,2,dotOff,11
1,1,944.3,573.3,1982,-285,1697,1,waiting,12
1,2,951,554,1496,-65,1431,1,waiting,12
1,3,950.7,555.2,2073,-275,1798,1,waiting,12
1,4,947.6,544.2,1830,-16,1814,1,waiting,12
1,5,952.4,557.4,1518,-70,1448,1,waiting,12
1,6,941.7,544.6,1964,-50,1914,1,waiting,12
1,7,956.3,552.1,1916,-285,1631,1,waiting,12
1,8,958.7,552.4,1771,-274,1497,1,waiting,12
1,9,959.3,548.1,1811,3,1814,1,waiting,12
1,10,956.9,553.3,2133,-285,1848,1,waiting,12
1,11,960.4,551,2202,-287,1915,1,waiting,12
1,12,957.7,556.5,2102,-271,1831,1,waiting,12
1,13,965.7,552,2134,-287,1847,1,waiting,12
1,14,959.1,556,1853,-6,1847,1,waiting,12
1,15,957.8,554.5,2180,-282,1898,1,waiting,12
1,16,955.3,552.8,1995,-281,1714,1,waiting,12
1,17,960.7,552.9,1746,-283,1463,1,waiting,12
1,18,952.5,549.8,1943,-279,1664,1,waiting,12
1,19,952.2,549.2,1972,-59,1913,1,waiting,12
1,20,957.3,555.7,1515,-34,1481,1,waiting,12
1,21,954.3,552.9,1501,-37,1464,1,waiting,12
1,22,962.2,546.9,1754,-74,1680,1,waiting,12
1,23,952.1,550.3,1910,-46,1864,1,waiting,12
1,24,960.3,551.3,1504,-56,1448,1,waiting,12
1,25,949.7,531.9,185,-165,20,1,waiting,12
1,25,958.5,546,1392,39,1431,2,waiting,12
1,26,956.2,554.3,1760,-80,1680,1,waiting,12
1,27,951.7,552.8,1875,-277,1598,1,waiting,12
1,28,955.2,554.1,1717,-186,1531,1,waiting,12
1,29,958.1,549.8,1842,-278,1564,1,waiting,12
1,30,963.1,547.6,1574,7,1581,1,waiting,12
1,31,955.5,552.2,1905,-42,1863,1,waiting,12
1,32,953.8,561.3,1606,-26,1580,1,waiting,12
1,33,961.8,548.1,1634,-39,1595,1,waiting,12
1,34,959.7,554,1737,-274,1463,1,waiting,12
1,35,955.2,541.5,1797,-283,1514,1,waiting,12
1,36,941,559.8,1673,-9,1664,1,waiting,12
1,37,958.1,565.6,235,-70,165,1,waiting,12
1,37,956.9,546,1391,174,1565,2,waiting,12
1,38,961.9,547,2149,-285,1864,1,waiting,12
1,39,963.1,544.8,1925,-277,1648,1,waiting,12
1,40,959.1,553.2,2097,-283,1814,1,waiting,12
1,1,950.4,555.3,1496,-276,1220,1,waiting,13
1,1,793.9,548.3,461,1253,1714,2,targOff,13
1,2,961.3,551.5,1367,-65,1302,1,waiting,13
1,2,1124.3,557.7,470,1328,1798,2,targOff,13
1,3,960.6,553.3,1343,-13,1330,1,waiting,13
1,3,1124.8,560.1,491,1357,1848,2,targOff,13
1,4,961.5,554.7,1241,-291,950,1,waiting,13
1,4,1134.3,559.1,462,985,1447,2,targOff,13
1,5,950.6,559.8,1417,-52,1365,1,waiting,13
1,5,782.5,552.2,471,1391,1862,2,targOff,13
1,6,963.1,562.5,1621,-290,1331,1,waiting,13
1,6,800.1,563.7,473,1356,1829,2,targOff,13
1,7,959.4,555.9,1260,-35,1225,1,waiting,13
1,7,1116.3,558.7,565,1249,1814,2,dotOff,13
1,8,952.7,552.8,1346,-274,1072,1,waiting,13
1,8,1124.4,554.9,473,1108,1581,2,targOff,13
1,9,956.6,549.1,1100,-12,1088,1,waiting,13
1,9,790.3,548.7,644,1120,1764,2,dotOff,13
1,10,953,552.1,1144,-2,1142,1,waiting,13
1,10,1114.9,554.1,352,1179,1531,2,waiting,13
1,10,1133.8,554.7,360,1550,1910,3,targOff,13
1,11,952.2,557.2,1253,-284,969,1,waiting,13
1,11,785.2,565,445,1002,1447,2,targOff,13
1,12,961.3,559.2,1413,-21,1392,1,waiting,13
1,12,1138.4,556.2,474,1423,1897,2,targOff,13
1,13,952,559.2,1637,-283,1354,1,waiting,13
1,13,790.7,566.2,462,1385,1847,2,targOff,13
1,14,959.6,547.5,1696,-282,1414,1,waiting,13
1,14,1137.6,551.9,474,1439,1913,2,targOff,13
1,15,950.4,563.6,1498,-281,1217,1,waiting,13
1,15,792.8,561.6,453,1244,1697,2,targOff,13
1,16,950.2,564.5,1267,-79,1188,1,waiting,13
1,16,781.5,567.7,460,1220,1680,2,targOff,13
1,17,954.2,553.5,1424,-284,1140,1,waiting,13
1,17,792,551.7,475,1173,1648,2,targOff,13
1,18,946.4,561.2,1228,-15,1213,1,waiting,13
1,18,794.9,554.4,470,1244,1714,2,targOff,13
1,19,956.4,557.4,1530,-280,1250,1,waiting,13
1,19,802.2,566.7,541,1273,1814,2,targVis,13
1,20,967.6,554.7,124,-124,0,1,waiting,13
1,20,950.6,559.7,1004,8,1012,2,waiting,13
1,20,775.8,560.2,491,1040,1531,3,targOff,13
1,21,951.9,562.1,1262,-273,989,1,waiting,13
1,21,1136,556.7,515,1016,1531,2,targVis,13
1,22,966.7,560,1319,-273,1046,1,waiting,13
1,22,1111,562.7,460,1071,1531,2,targOff,13
1,23,931.8,553.6,282,-281,1,1,waiting,13
1,23,948.2,557.3,1108,11,1119,2,waiting,13
1,23,778.3,557.2,461,1151,1612,3,targOff,13
1,24,954.7,552.8,1453,-281,1172,1,waiting,13
1,24,780.9,555.3,465,1198,1663,2,targOff,13
1,25,957.8,559.8,1090,-40,1050,1,waiting,13
1,25,1137.6,551.9,638,1076,1714,2,dotOff,13
1,26,946.4,562.5,1083,-30,1053,1,waiting,13
1,26,1125.8,559.8,475,1089,1564,2,targOff,13
1,27,963.4,559,1637,-286,1351,1,waiting,13
1,27,802.6,552.9,500,1380,1880,2,targOff,13
1,28,951.2,557.3,1332,-270,1062,1,waiting,13
1,28,1116.2,558.7,354,1094,1448,2,targOff,13
1,29,958.3,559.4,1205,-278,927,1,waiting,13
1,29,1100.9,553,594,953,1547,2,dotOff,13
1,30,959.8,557.8,1656,-286,1370,1,waiting,13
1,30,855.2,557.6,139,1389,1528,2,targVis,13
1,30,802.1,560.6,372,1542,1914,3,targOff,13
1,31,955.1,551.5,1485,-282,1203,1,waiting,13
1,31,1017,551.9,217,1226,1443,2,waiting,13
1,31,1135.6,546.7,447,1467,1914,3,targOff,13
1,32,953.6,557,1292,-12,1280,1,waiting,13
1,32,778.8,552.4,468,1313,1781,2,targOff,13
1,33,958.2,552.6,1332,-16,1316,1,waiting,13
1,33,771.2,554.8,443,1350,1793,2,targOff,13
1,34,957.8,556.7,1499,-277,1222,1,waiting,13
1,34,781,555.7,477,1254,1731,2,targOff,13
1,35,955.8,555.6,1976,-279,1697,1,waiting,13
1,36,961.9,551,1486,-274,1212,1,waiting,13
1,36,1124.6,551.3,626,1238,1864,2,dotOff,13
1,37,958.5,552.8,1396,-43,1353,1,waiting,13
1,37,806.5,564.4,519,1378,1897,2,targVis,13
1,38,961.5,548.2,1278,-44,1234,1,waiting,13
1,38,789.2,556.2,471,1259,1730,2,targOff,13
1,39,964,554.8,1503,-284,1219,1,waiting,13
1,39,1135.2,550.6,519,1245,1764,2,targVis,13
1,40,958.4,542.3,1404,-284,1120,1,waiting,13
1,40,1120.7,555.2,495,1153,1648,2,targOff,13
1,1,941.8,553.6,290,-280,10,1,waiting,14
1,1,958.6,554.9,1808,19,1827,2,waiting,14
1,2,960.7,552.8,1534,-36,1498,1,waiting,14
1,3,969,557,2041,-280,1761,1,waiting,14
1,4,964.2,552.7,1865,-284,1581,1,waiting,14
1,5,966.8,551.1,1816,-285,1531,1,waiting,14
1,6,969.8,549.4,1488,-41,1447,1,waiting,14
1,7,967.8,544,2087,-290,1797,1,waiting,14
1,8,954,552.5,1878,-82,1796,1,waiting,14
1,9,967.2,544.6,278,-274,4,1,waiting,14
1,9,965.5,546.8,1860,21,1881,2,waiting,14
1,10,960.6,546.5,2023,-109,1914,1,waiting,14
1,11,968.5,544.5,1573,-42,1531,1,waiting,14
1,12,967.7,554.5,1794,-280,1514,1,waiting,14
1,13,973.3,551.9,210,-18,192,1,waiting,14
1,13,940.7,558.9,136,203,339,2,waiting,14
1,13,967.7,551.1,1150,348,1498,3,waiting,14
1,14,968.6,548.1,1576,-46,1530,1,waiting,14
1,15,975.8,553.3,1878,-197,1681,1,waiting,14
1,16,965.9,546.2,1872,-58,1814,1,waiting,14
1,17,955.1,553,2029,-280,1749,1,waiting,14
1,18,970.1,551.1,1776,-279,1497,1,waiting,14
1,19,971.4,549.2,1578,-47,1531,1,waiting,14
1,20,969.7,551.1,2114,-283,1831,1,waiting,14
1,21,979.8,563.5,122,-94,28,1,waiting,14
1,21,974.2,540.8,1766,43,1809,2,waiting,14
1,22,967,549.9,1559,5,1564,1,waiting,14
1,23,971.1,551.1,1737,-173,1564,1,waiting,14
1,24,968.3,554.2,1714,-117,1597,1,waiting,14
1,25,975.5,546.1,2163,-249,1914,1,waiting,14
1,26,980.5,544.1,1705,-242,1463,1,waiting,14
1,27,968.9,546.7,1687,-40,1647,1,waiting,14
1,28,969.6,544,1888,-278,1610,1,waiting,14
1,29,971,547.6,1711,-280,1431,1,waiting,14
1,30,970.2,547.4,1682,-21,1661,1,waiting,14
1,31,972.2,544.6,2036,-272,1764,1,waiting,14
1,32,968.1,542.4,1738,10,1748,1,waiting,14
1,33,977.9,544.9,1641,-14,1627,1,waiting,14
1,34,974.8,548.8,1807,-276,1531,1,waiting,14
1,35,967.7,550.7,1785,-288,1497,1,waiting,14
1,36,970.5,545.6,1887,-273,1614,1,waiting,14
1,37,969.3,547.4,1976,-279,1697,1,waiting,14
1,38,977.2,547.1,1654,-57,1597,1,waiting,14
1,39,971,551.3,1733,-36,1697,1,waiting,14
1,40,974.8,548.6,1721,-57,1664,1,waiting,14
1,1,939,544.8,223,-7,216,1,waiting,15
1,1,973.4,544.5,826,225,1051,2,waiting,15
1,1,1130.9,545.6,436,1077,1513,3,targOff,15
1,2,974.9,545,1320,-39,1281,1,waiting,15
1,2,786.6,540.2,589,1309,1898,2,dotOff,15
1,3,971.2,547.4,1239,-8,1231,1,waiting,15
1,3,1127.9,552.7,452,1259,1711,2,targOff,15
1,4,971.9,555.5,1249,-86,1163,1,waiting,15
1,4,1139.5,554.1,607,1191,1798,2,dotOff,15
1,5,970,550.7,1343,-275,1068,1,waiting,15
1,5,1138.1,549.2,702,1095,1797,2,waiting,15
1,6,972.2,545.1,1471,-190,1281,1,waiting,15
1,6,781.5,543.9,432,1316,1748,2,targOff,15
1,7,970.7,548.5,1157,-30,1127,1,waiting,15
1,7,785.3,548,461,1153,1614,2,targOff,15
1,8,966.1,548,1298,-275,1023,1,waiting,15
1,8,1149.8,551,498,1049,1547,2,targOff,15
1,9,979.1,545,1263,-284,979,1,waiting,15
1,9,1113.5,542.4,427,1003,1430,2,targOff,15
1,10,964.3,550.4,1056,-66,990,1,waiting,15
1,10,808.1,542.4,458,1015,1473,2,waiting,15
1,10,776.9,540.4,416,1482,1898,3,targOff,15
1,11,965.2,547,1581,-277,1304,1,waiting,15
1,11,784.2,550.7,460,1337,1797,2,targOff,15
1,12,961.3,545.1,1175,-25,1150,1,waiting,15
1,12,778,552.3,448,1183,1631,2,targOff,15
1,13,968.6,549.6,1618,-287,1331,1,waiting,15
1,13,1121.1,544.9,476,1355,1831,2,targOff,15
1,14,967,551.1,1420,-272,1148,1,waiting,15
1,14,1115,537.2,426,1173,1599,2,targOff,15
1,15,962.1,548.3,1078,-49,1029,1,waiting,15
1,15,775.7,541.5,485,1063,1548,2,targOff,15
1,16,973.8,540.8,1116,-12,1104,1,waiting,15
1,16,1132,542.4,717,1130,1847,2,waiting,15
1,17,966.5,549.1,1273,-280,993,1,waiting,15
1,17,1148,548.6,178,1019,1197,2,waiting,15
1,18,968.2,548.4,1384,-274,1110,1,waiting,15
1,18,1136.2,544.2,343,1138,1481,2,targOff,15
1,19,975.2,551.3,1543,-275,1268,1,waiting,15
1,19,797.9,539.6,454,1293,1747,2,targOff,15
1,20,969.2,538.6,1639,-279,1360,1,waiting,15
1,20,1151,543.3,493,1386,1879,2,targOff,15
1,21,967.4,541.2,1146,-76,1070,1,waiting,15
1,21,1137.7,546.8,452,1096,1548,2,targOff,15
1,22,971.8,543.5,1326,-58,1268,1,waiting,15
1,22,1135.7,542.5,477,1303,1780,2,targOff,15
1,23,968.1,542.4,1347,-288,1059,1,waiting,15
1,23,1123.4,537.1,579,1084,1663,2,dotOff,15
1,24,969.5,536.8,1142,-18,1124,1,waiting,15
1,24,1128,540.8,476,1152,1628,2,targOff,15
1,25,985,532.2,171,-160,11,1,waiting,15
1,25,966.5,542.4,1080,19,1099,2,waiting,15
1,25,811.5,535.8,473,1124,1597,3,targOff,15
1,26,974.5,543.2,1561,-244,1317,1,waiting,15
1,26,1136.9,545.1,555,1342,1897,2,targVis,15
1,27,967.9,538.9,1458,-284,1174,1,waiting,15
1,27,1144.7,541.1,524,1207,1731,2,targVis,15
1,28,967.6,544,1262,-279,983,1,waiting,15
1,28,1137.2,545.1,457,1008,1465,2,targOff,15
1,29,962.8,549.5,1586,-287,1299,1,waiting,15
1,29,782.4,543.4,545,1332,1877,2,targVis,15
1,30,970.8,541.3,1009,-41,968,1,waiting,15
1,30,827.9,537.4,110,992,1102,2,targOff,15
1,30,752.9,545.3,166,1125,1291,3,targOff,15
1,30,791.5,541.3,100,1314,1414,4,targOff,15
1,31,880.8,544.5,223,-43,180,1,waiting,15
1,31,919.3,540,83,204,287,2,waiting,15
1,31,964.8,543.6,615,308,923,3,waiting,15
1,31,774.4,537.8,240,957,1197,4,waiting,15
1,32,970.6,539.9,1385,-217,1168,1,waiting,15
1,32,815.6,536.4,300,1194,1494,2,waiting,15
1,32,790.5,535,396,1502,1898,3,targOff,15
1,33,965.7,549.1,1425,-281,1144,1,waiting,15
1,33,1110.8,552.1,138,1180,1318,2,targVis,15
1,33,1136.7,546.7,392,1339,1731,3,targOff,15
1,34,969.1,537.4,1352,-282,1070,1,waiting,15
1,34,1118.2,538.4,305,1096,1401,2,waiting,15
1,34,1147.5,538.1,375,1422,1797,3,targOff,15
1,35,968.9,539.9,1423,-286,1137,1,waiting,15
1,35,1135.8,550.7,466,1165,1631,2,targOff,15
1,36,970,540.1,1256,-57,1199,1,waiting,15
1,36,777.4,533.2,487,1226,1713,2,targOff,15
1,37,962.4,548.2,1283,-52,1231,1,waiting,15
1,37,789.7,537.4,458,1256,1714,2,targOff,15
1,38,963,540.3,1577,-282,1295,1,waiting,15
1,38,800.1,528.6,457,1320,1777,2,targOff,15
1,39,965.7,544.8,1495,-279,1216,1,waiting,15
1,39,1132.4,544.6,461,1253,1714,2,targOff,15
1,40,963.5,550.1,1475,-278,1197,1,waiting,15
1,40,1140.9,543.2,507,1224,1731,2,targOff,15
1,1,967.1,543.6,2067,-287,1780,1,waiting,16
1,2,965.8,537.3,1875,-30,1845,1,waiting,16
1,3,964.4,543.6,1773,8,1781,1,waiting,16
1,4,972.4,544.4,1781,-267,1514,1,waiting,16
1,5,967.5,551,1594,3,1597,1,waiting,16
1,6,962.5,543.4,1873,-275,1598,1,waiting,16
1,7,952.9,547.5,342,-275,67,1,waiting,16
1,7,960.4,544.8,1677,86,1763,2,waiting,16
1,8,966.5,536.8,2021,-273,1748,1,waiting,16
1,9,977.8,551.2,1756,-275,1481,1,waiting,16
1,10,970.2,543.2,2009,-280,1729,1,waiting,16
1,11,955.1,552.1,1703,-273,1430,1,waiting,16
1,12,960.4,544.9,1931,-284,1647,1,waiting,16
1,13,955.8,529.1,163,-140,23,1,waiting,16
1,13,958.9,548.8,1576,38,1614,2,waiting,16
1,14,965.9,548.3,1536,-76,1460,1,waiting,16
1,15,965,545.1,1429,2,1431,1,waiting,16
1,16,960.2,554.1,1861,-280,1581,1,waiting,16
1,17,962.5,546.5,1875,-280,1595,1,waiting,16
1,18,951.4,544,1757,-277,1480,1,waiting,16
1,19,952.5,556,287,-278,9,1,waiting,16
1,19,958.4,544.3,1510,18,1528,2,waiting,16
1,20,954,543.9,1953,-188,1765,1,waiting,16
1,21,960,546.7,1488,-24,1464,1,waiting,16
1,22,961.4,544.6,1951,-287,1664,1,waiting,16
1,23,959.3,543,1832,-18,1814,1,waiting,16
1,24,954.7,542.9,1763,-16,1747,1,waiting,16
1,25,960.5,546.6,1740,-43,1697,1,waiting,16
1,26,946.1,546.9,1730,-16,1714,1,waiting,16
1,27,956.9,542.9,1788,-274,1514,1,waiting,16
1,28,954.8,545.2,1571,8,1579,1,waiting,16
1,29,966,546.6,1715,-52,1663,1,waiting,16
1,30,958.9,544.7,1809,-279,1530,1,waiting,16
1,31,959.5,538.8,2028,-280,1748,1,waiting,16
1,32,955.3,550.5,1644,-13,1631,1,waiting,16
1,33,969.8,576.2,129,-108,21,1,waiting,16
1,33,959.1,540.9,1657,41,1698,2,waiting,16
1,34,963.7,542,1703,-289,1414,1,waiting,16
1,35,956.8,545.7,1611,-31,1580,1,waiting,16
1,36,956.1,535.9,1860,-280,1580,1,waiting,16
1,37,955.8,542.2,1723,-46,1677,1,waiting,16
1,38,962.4,525,332,-109,223,1,waiting,16
1,38,945.5,540.3,1646,232,1878,2,waiting,16
1,39,946.8,542.1,2001,-287,1714,1,waiting,16
1,40,943.9,538.7,1821,-40,1781,1,waiting,16
1,1,935.1,525.9,337,-280,57,1,waiting,17
1,1,961,528.2,983,66,1049,2,waiting,17
1,1,775.6,528,365,1082,1447,3,targOff,17
1,2,956.5,535,1377,-291,1086,1,waiting,17
1,2,806.2,532.3,214,1113,1327,2,waiting,17
1,2,778.6,535.5,544,1337,1881,3,targVis,17
1,3,958.9,538,1476,-275,1201,1,waiting,17
1,3,831.2,538.1,156,1224,1380,2,dotOff,17
1,3,792.4,534.6,556,1392,1948,3,targVis,17
1,4,952,530.8,1173,-83,1090,1,waiting,17
1,4,1137.6,533.1,441,1124,1565,2,targOff,17
1,5,967.3,529.4,1232,-275,957,1,waiting,17
1,5,785.2,533.5,458,989,1447,2,targOff,17
1,6,972,528.1,1334,-279,1055,1,waiting,17
1,6,1066.7,539.1,143,1079,1222,2,dotOff,17
1,6,1123.9,538.5,491,1240,1731,3,targOff,17
1,7,968.8,530.8,1369,-277,1092,1,waiting,17
1,7,795,538,478,1119,1597,2,targOff,17
1,8,968.9,531.8,1355,-296,1059,1,waiting,17
1,8,775.1,535.5,488,1088,1576,2,targOff,17
1,9,967.1,537.7,1004,-46,958,1,waiting,17
1,9,785.4,536.2,478,985,1463,2,targOff,17
1,10,961.7,536.3,1104,-75,1029,1,waiting,17
1,10,808.6,534.5,688,1059,1747,2,waiting,17
1,11,966.1,531.8,1613,-275,1338,1,waiting,17
1,11,1102.5,533,445,1369,1814,2,targOff,17
1,12,968.7,533.4,1604,-275,1329,1,waiting,17
1,12,1128.8,534,476,1355,1831,2,targOff,17
1,13,968.9,537.1,1382,-283,1099,1,waiting,17
1,13,1118,538.4,637,1127,1764,2,dotOff,17
1,14,963.8,533.3,1468,-277,1191,1,waiting,17
1,14,1146.9,536,512,1219,1731,2,targOff,17
1,15,963.8,528.5,1420,-280,1140,1,waiting,17
1,15,1131.2,523,456,1175,1631,2,targOff,17
1,16,970.3,536.2,1244,-52,1192,1,waiting,17
1,16,1126.7,535.6,496,1219,1715,2,targOff,17
1,17,962.3,531.1,1273,-275,998,1,waiting,17
1,17,1131.8,526.9,485,1029,1514,2,targOff,17
1,18,956.4,536.1,1229,-277,952,1,waiting,17
1,18,778.5,538.5,481,983,1464,2,targOff,17
1,19,969.5,531.4,1343,-278,1065,1,waiting,17
1,19,776.2,533.3,545,1102,1647,2,targVis,17
1,20,959.3,531.5,1081,-53,1028,1,waiting,17
1,20,757,545.6,311,1062,1373,2,targOff,17
1,20,791.2,535.8,127,1386,1513,3,targOff,17
1,21,959.1,538.8,1174,-75,1099,1,waiting,17
1,21,1129.6,535.4,688,1126,1814,2,waiting,17
1,22,960.2,532.1,1339,-281,1058,1,waiting,17
1,22,1125.4,540.2,772,1092,1864,2,waiting,17
1,23,961.1,534.4,1338,-282,1056,1,waiting,17
1,23,798.4,543.7,428,1086,1514,2,targOff,17
1,24,952.2,538.7,1235,-64,1171,1,waiting,17
1,24,788.1,541.7,677,1203,1880,2,waiting,17
1,25,974,535.9,1058,-285,773,1,waiting,17
1,25,1115.2,537.2,530,800,1330,2,dotOff,17
1,26,960.6,542.6,1053,-11,1042,1,waiting,17
1,26,1099.4,542.4,380,1068,1448,2,targOff,17
1,27,966.9,533.5,1374,-278,1096,1,waiting,17
1,27,1140.1,537,689,1125,1814,2,waiting,17
1,28,964.7,536.3,1204,-30,1174,1,waiting,17
1,28,1107.4,532.8,414,1198,1612,2,targOff,17
1,29,962.6,533.2,1366,-164,1202,1,waiting,17
1,29,787.9,541.8,452,1229,1681,2,targOff,17
1,30,977,528,294,-280,14,1,waiting,17
1,30,957.5,536.3,1190,22,1212,2,waiting,17
1,30,1125.8,533,471,1238,1709,3,targOff,17
1,31,962.7,532.5,1586,-281,1305,1,waiting,17
1,31,1122.9,531.4,446,1335,1781,2,targOff,17
1,32,962.9,534.3,1376,-279,1097,1,waiting,17
1,32,1118.1,537.6,591,1123,1714,2,dotOff,17
1,33,955.5,540.4,1356,-281,1075,1,waiting,17
1,33,1098.9,533.7,299,1100,1399,2,waiting,17
1,33,1139.5,534.9,447,1417,1864,3,targOff,17
1,34,961.3,537.9,1322,-282,1040,1,waiting,17
1,34,809.3,543.3,297,1064,1361,2,targOff,17
1,34,782.8,535.9,77,1370,1447,3,targOff,17
1,35,967.8,537.6,1277,-279,998,1,waiting,17
1,35,1101.9,538.4,421,1026,1447,2,targOff,17
1,36,966.4,529.3,1246,-282,964,1,waiting,17
1,36,1115,532.7,361,987,1348,2,waiting,17
1,36,1138.1,533.4,390,1358,1748,3,targOff,17
1,37,960.5,542.9,1684,-275,1409,1,waiting,17
1,37,1111.3,540.1,369,1433,1802,2,targOff,17
1,37,1148.6,532.9,32,1816,1848,3,targOff,17
1,38,960.5,536,1252,-290,962,1,waiting,17
1,38,791,541.5,427,987,1414,2,targOff,17
1,39,959.6,537.4,1113,-99,1014,1,waiting,17
1,39,1130.8,541.2,457,1040,1497,2,targOff,17
1,40,969.3,539.3,1436,-280,1156,1,waiting,17
1,40,1154.7,531.4,497,1182,1679,2,dotOff,17
1,40,1131.6,543,73,1691,1764,3,targOff,17
1,1,972.1,524.6,1518,-4,1514,1,waiting,18
1,2,955.9,531.6,1903,-72,1831,1,waiting,18
1,3,960.5,534.7,2060,-281,1779,1,waiting,18
1,4,958.9,532.8,2005,-274,1731,1,waiting,18
1,5,970.1,527.6,1511,-14,1497,1,waiting,18
1,6,956.8,531.4,1970,-273,1697,1,waiting,18
1,7,964.9,539,2005,-279,1726,1,waiting,18
1,8,959.1,539.2,1934,-286,1648,1,waiting,18
1,9,963.9,538.2,1972,-92,1880,1,waiting,18
1,10,973.6,537,1916,-286,1630,1,waiting,18
1,11,972.8,533.7,2000,-285,1715,1,waiting,18
1,12,968,542.8,1711,-280,1431,1,waiting,18
1,13,962.4,539.4,1963,-283,1680,1,waiting,18
1,14,965.3,536.6,1821,-41,1780,1,waiting,18
1,15,968,532.1,1617,-271,1346,1,waiting,18
1,16,966.6,540.5,1749,-285,1464,1,waiting,18
1,17,966.1,534.2,1722,-275,1447,1,waiting,18
1,18,955,537,2166,-285,1881,1,waiting,18
1,19,967.6,540.2,1922,-278,1644,1,waiting,18
1,20,971.5,535.6,2109,-279,1830,1,waiting,18
1,21,970,534.5,1584,-19,1565,1,waiting,18
1,22,969.7,538.8,1771,-223,1548,1,waiting,18
1,23,968.6,536.5,1555,-24,1531,1,waiting,18
1,24,970.4,540.5,1779,-284,1495,1,waiting,18
1,25,966.1,543.8,1841,-278,1563,1,waiting,18
1,26,971.2,532.2,1949,-285,1664,1,waiting,18
1,27,968.1,537.9,1916,-286,1630,1,waiting,18
1,28,970,541,1837,-273,1564,1,waiting,18
1,29,965.6,541.5,1774,-26,1748,1,waiting,18
1,30,963.2,541.6,2139,-279,1860,1,waiting,18
1,31,958.1,539.3,1916,-285,1631,1,waiting,18
1,32,990.5,539.6,184,-120,64,1,waiting,18
1,32,967.4,533.1,582,71,653,2,waiting,18
1,32,976.1,537.7,1069,662,1731,3,waiting,18
1,33,969.4,544.9,1768,-38,1730,1,waiting,18
1,34,967.1,537.9,1984,-271,1713,1,waiting,18
1,35,967.6,537.1,2142,-278,1864,1,waiting,18
1,36,953.7,539.8,2071,-274,1797,1,waiting,18
1,37,960.4,537.8,1881,-34,1847,1,waiting,18
1,38,959.4,540.2,1901,-270,1631,1,waiting,18
1,39,962,540.4,1912,-282,1630,1,waiting,18
1,40,954.5,533.8,172,-66,106,1,waiting,18
1,40,955.4,537.8,1679,114,1793,2,waiting,18
1,1,978,529.9,1085,-10,1075,1,waiting,19
1,1,1145.9,536.1,428,1101,1529,2,targOff,19
1,2,966.2,531.9,1221,-289,932,1,waiting,19
1,2,786.8,535.6,679,965,1644,2,dotOff,19
1,3,967.7,535.3,1105,-66,1039,1,waiting,19
1,3,820.4,526.1,225,1064,1289,2,waiting,19
1,3,781.9,530.4,396,1302,1698,3,targOff,19
1,4,959.9,536.9,1231,-241,990,1,waiting,19
1,4,809.7,533,233,1017,1250,2,targOff,19
1,4,774.1,534.2,134,1263,1397,3,targOff,19
1,5,963.4,525.7,1160,-151,1009,1,waiting,19
1,5,827.2,533.9,174,1034,1208,2,waiting,19
1,5,792.3,539.4,608,1222,1830,3,dotOff,19
1,6,972.3,538.6,1330,-280,1050,1,waiting,19
1,6,1132.8,540.3,586,1076,1662,2,dotOff,19
1,7,968.2,534.9,1419,-30,1389,1,waiting,19
1,7,799.8,538.7,428,1419,1847,2,targOff,19
1,8,962.7,537.7,1559,-285,1274,1,waiting,19
1,8,781.7,533.8,490,1308,1798,2,targOff,19
1,9,963.3,539.1,1295,-112,1183,1,waiting,19
1,9,786.1,539.7,461,1219,1680,2,targOff,19
1,10,961.7,539.4,1249,-274,975,1,waiting,19
1,10,784.6,534.9,438,1009,1447,2,targOff,19
1,11,960.2,535,1241,-278,963,1,waiting,19
1,11,1117.8,537.9,609,988,1597,2,dotOff,19
1,12,969,539.5,1200,8,1208,1,waiting,19
1,12,806.5,539.5,658,1239,1897,2,waiting,19
1,13,948.6,530.1,281,-281,0,1,waiting,19
1,13,968.4,532.2,1379,9,1388,2,waiting,19
1,13,800.2,541.2,456,1422,1878,3,targOff,19
1,14,964.9,545.7,1405,-46,1359,1,waiting,19
1,14,778.9,545.5,452,1395,1847,2,targOff,19
1,15,970.5,534,1230,-44,1186,1,waiting,19
1,15,785.9,539.9,447,1217,1664,2,targOff,19
1,16,967.1,537.1,1559,-281,1278,1,waiting,19
1,16,797,541.7,461,1303,1764,2,targOff,19
1,17,962.5,536.2,1050,-46,1004,1,waiting,19
1,17,796.2,536.1,486,1028,1514,2,targOff,19
1,18,974.4,546.5,1209,-62,1147,1,waiting,19
1,18,1127,541.2,713,1185,1898,2,waiting,19
1,19,962.6,539.4,1168,8,1176,1,waiting,19
1,19,774.4,543.1,482,1211,1693,2,targOff,19
1,20,964.8,537.8,1252,-16,1236,1,waiting,19
1,20,799,542,477,1270,1747,2,targOff,19
1,21,977.6,531.9,248,-31,217,1,waiting,19
1,21,959.3,537,1106,225,1331,2,waiting,19
1,21,1134.7,535.8,476,1372,1848,3,targOff,19
1,22,971.8,540.4,1168,-48,1120,1,waiting,19
1,22,1121.4,541.1,53,1157,1210,2,targVis,19
1,22,1172.6,542.6,199,1239,1438,3,targOff,19
1,22,1126.7,547.1,244,1454,1698,4,targOff,19
1,23,962,542.7,1119,-75,1044,1,waiting,19
1,23,1128.4,539.2,810,1083,1893,2,waiting,19
1,24,971.6,539.7,1401,-280,1121,1,waiting,19
1,24,788.7,543.8,446,1148,1594,2,targOff,19
1,25,966.3,533,1031,-73,958,1,waiting,19
1,25,1117.4,542,449,982,1431,2,targOff,19
1,26,963.6,545.2,1027,-48,979,1,waiting,19
1,26,1129,544.1,492,1005,1497,2,targOff,19
1,27,965.4,534.9,1371,-280,1091,1,waiting,19
1,27,1111.6,535.6,698,1116,1814,2,waiting,19
1,28,968.6,540.1,1279,-275,1004,1,waiting,19
1,28,1123.5,542.3,452,1029,1481,2,targOff,19
1,29,972.1,539.7,1351,-125,1226,1,waiting,19
1,29,1126.8,534,479,1252,1731,2,targOff,19
1,30,973.8,534.6,1097,-71,1026,1,waiting,19
1,30,1063.5,528.7,198,1049,1247,2,waiting,19
1,30,1133.4,531.3,452,1268,1720,3,dotOff,19
1,31,968.8,537.4,1033,-17,1016,1,waiting,19
1,31,824.3,544.3,159,1043,1202,2,targVis,19
1,31,792.6,547.2,337,1212,1549,3,targOff,19
1,32,970.2,538.4,1505,-283,1222,1,waiting,19
1,32,777,537.2,473,1258,1731,2,targOff,19
1,33,948.5,514.8,239,-78,161,1,waiting,19
1,33,966.5,536,989,178,1167,2,waiting,19
1,33,1151.5,534.6,415,1193,1608,3,targOff,19
1,34,972.5,541.3,1387,-288,1099,1,waiting,19
1,34,1135.1,537.8,456,1124,1580,2,targOff,19
1,35,967.3,535.2,1283,-285,998,1,waiting,19
1,35,785.5,532.8,425,1025,1450,2,targOff,19
1,36,975,537.1,956,-14,942,1,waiting,19
1,36,1125.8,534.8,461,967,1428,2,targOff,19
1,37,975.2,541.3,1383,-282,1101,1,waiting,19
1,37,1125.9,530.1,484,1126,1610,2,targOff,19
1,38,967.2,535.9,1028,-10,1018,1,waiting,19
1,38,808.4,540.8,437,1043,1480,2,targOff,19
1,39,967.4,536.7,940,-1,939,1,waiting,19
1,39,1123.1,536.4,579,966,1545,2,dotOff,19
1,40,964,536.8,1082,-46,1036,1,waiting,19
1,40,1112.3,536.5,585,1062,1647,2,dotOff,19
1,1,968.2,539.7,1552,-20,1532,1,waiting,20
1,2,965.7,535.3,1837,-273,1564,1,waiting,20
1,3,958.4,544.3,1683,-2,1681,1,waiting,20
1,4,971.9,537.4,1666,-119,1547,1,waiting,20
1,5,966.6,538.2,1875,-144,1731,1,waiting,20
1,6,1001.7,554.5,180,-102,78,1,waiting,20
1,6,974.9,534.5,1535,94,1629,2,waiting,20
1,7,964.2,531,2035,-271,1764,1,waiting,20
1,8,972,540.1,2150,-286,1864,1,waiting,20
1,9,966,538.9,2157,-275,1882,1,waiting,20
1,10,997.3,530.1,142,-142,0,1,waiting,20
1,10,963.1,537.1,1704,10,1714,2,waiting,20
1,11,969.7,557.1,1740,-277,1463,1,waiting,20
1,12,967.7,558.2,1845,-30,1815,1,waiting,20
1,13,1012.4,570,111,-61,50,1,waiting,20
1,13,970.7,553.6,1560,70,1630,2,waiting,20
1,14,970.8,555.3,1705,-37,1668,1,waiting,20
1,15,971.5,559.7,1636,-22,1614,1,waiting,20
1,16,969.5,547.9,1747,-283,1464,1,waiting,20
1,17,963.8,553.5,1847,-287,1560,1,waiting,20
1,18,976.1,537.1,199,138,337,1,waiting,20
1,18,979.8,554.6,130,350,480,2,waiting,20
1,18,965.1,545,557,490,1047,3,waiting,20
1,19,968.3,553.9,2005,-283,1722,1,waiting,20
1,19,1019.9,552.2,121,1743,1864,2,targOff,20
1,20,966.5,551.1,1793,-12,1781,1,waiting,20
1,21,967.7,547.7,1509,-46,1463,1,waiting,20
1,22,966.7,550.2,1670,-56,1614,1,waiting,20
1,23,961,550.1,1514,-17,1497,1,waiting,20
1,24,968.7,551.9,1900,-19,1881,1,waiting,20
1,25,964.4,548,1989,-158,1831,1,waiting,20
1,26,966.4,469.9,176,-122,54,1,waiting,20
1,26,971.4,546.9,1524,82,1606,2,waiting,20
1,26,1038,548.9,57,1624,1681,3,targOff,20
1,27,959.6,540.1,2089,-292,1797,1,waiting,20
1,28,974.8,537.4,1579,-272,1307,1,waiting,20
1,28,1122.5,554.8,370,1341,1711,2,targOff,20
1,28,1000.4,535.9,113,1734,1847,3,targOff,20
1,29,939,627.3,147,144,291,1,waiting,20
1,29,944.5,583.8,54,314,368,2,waiting,20
1,29,963.6,550.1,559,388,947,3,waiting,20
1,30,965.6,550.7,1904,-274,1630,1,waiting,20
1,31,960.9,548.3,1948,-84,1864,1,waiting,20
1,32,958.3,557.6,1912,-281,1631,1,waiting,20
1,33,958.6,554.8,2159,-279,1880,1,waiting,20
1,34,965.3,555.6,1752,-271,1481,1,waiting,20
1,35,969.5,556.8,1650,14,1664,1,waiting,20
1,36,956.6,559.3,1967,-54,1913,1,waiting,20
1,37,965.3,552,1637,10,1647,1,waiting,20
1,38,962.9,554.4,1924,-271,1653,1,waiting,20
1,39,955.4,552.8,1459,-28,1431,1,waiting,20
1,40,963,554.8,1771,-274,1497,1,waiting,20
2,1,956.2,537.4,1357,14,1371,1,waiting,1
2,1,1127.4,537.7,380,1401,1781,2,targOff,1
2,2,936.3,542.4,1514,-276,1238,1,waiting,1
2,2,1102.5,527.8,549,1265,1814,2,targVis,1
2,3,1045.5,513.4,529,-281,248,1,waiting,1
2,3,1099.9,542.4,173,264,437,2,waiting,1
2,3,1100,542.8,693,555,1248,3,waiting,1
2,4,933.7,533.8,1383,-281,1102,1,waiting,1
2,4,1115.1,537,457,1140,1597,2,targOff,1
2,5,940.6,535.1,1398,-18,1380,1,waiting,1
2,5,1082.6,523.4,538,1410,1948,2,targVis,1
2,6,932.3,546,1509,-186,1323,1,waiting,1
2,6,775.6,540.3,516,1349,1865,2,targVis,1
2,7,936.5,545.4,1215,3,1218,1,waiting,1
2,7,1111.9,550,412,1251,1663,2,targOff,1
2,8,1121.7,532.8,299,-285,14,1,waiting,1
2,8,927.8,548.7,1487,51,1538,2,waiting,1
2,8,1097.7,523.9,49,1565,1614,3,targOff,1
2,9,915.6,555.4,171,23,194,1,waiting,1
2,9,932.6,540.9,1230,204,1434,2,waiting,1
2,9,1107.1,542.4,534,1465,1999,3,targVis,1
2,10,1130.5,537,329,-278,51,1,waiting,1
2,10,931.2,551.4,1386,84,1470,2,waiting,1
2,10,1106.3,544.3,284,1496,1780,3,targOff,1
2,11,932.1,544.2,1175,7,1182,1,waiting,1
2,11,752.9,536.1,453,1212,1665,2,targOff,1
2,12,939,555.7,308,-279,29,1,waiting,1
2,12,936.9,539.3,1303,37,1340,2,waiting,1
2,12,1130,536.3,304,1373,1677,3,targOff,1
2,13,935.5,532.5,1560,-284,1276,1,waiting,1
2,13,768.8,524.2,557,1307,1864,2,targVis,1
2,14,930,537.8,2003,-272,1731,1,waiting,1
2,15,921,532,1485,-285,1200,1,waiting,1
2,15,1083,521.8,539,1225,1764,2,targVis,1
2,16,947.3,534.5,283,-276,7,1,waiting,1
2,16,921.4,528.2,1327,14,1341,2,waiting,1
2,16,759.3,522.1,513,1367,1880,3,targVis,1
2,17,919,533.6,1110,-280,830,1,waiting,1
2,18,934.6,533.2,1294,-284,1010,1,waiting,1
2,18,764,536.4,562,1035,1597,2,targVis,1
2,19,929.8,539.7,1510,-276,1234,1,waiting,1
2,19,1092.4,541.1,538,1259,1797,2,targVis,1
2,20,1075.1,535.7,311,-279,32,1,waiting,1
2,20,922.1,531.9,957,57,1014,2,waiting,1
2,21,930.2,538.2,1029,0,1029,1,waiting,1
2,21,733.4,534.7,519,1062,1581,2,targVis,1
2,22,926.3,532,207,-9,198,1,waiting,1
2,22,931.4,533,975,206,1181,2,waiting,1
2,22,1101.4,529.1,363,1217,1580,3,targOff,1
2,23,928.9,560,1453,-278,1175,1,waiting,1
2,23,1093.3,551.3,345,1200,1545,2,targOff,1
2,24,1029.7,521.1,295,-276,19,1,waiting,1
2,24,932.1,541.1,1193,39,1232,2,waiting,1
2,24,738.7,528.2,285,1267,1552,3,targOff,1
2,24,767.6,528.7,71,1560,1631,4,targOff,1
2,25,931.4,533.8,1415,-281,1134,1,waiting,1
2,25,760.7,542.9,397,1167,1564,2,targOff,1
2,26,931.3,533.2,1506,-77,1429,1,waiting,1
2,26,761.6,540.2,532,1464,1996,2,targVis,1
2,27,924.6,531.7,1357,-285,1072,1,waiting,1
2,27,757,545.5,534,1097,1631,2,targVis,1
2,28,929.7,531,1441,-287,1154,1,waiting,1
2,28,783,543.4,260,1180,1440,2,targVis,1
2,28,749.5,541.5,282,1449,1731,3,targOff,1
2,29,937.2,538,1339,-171,1168,1,waiting,1
2,29,758.3,535.7,545,1203,1748,2,targVis,1
2,30,947.8,526.3,1258,-47,1211,1,waiting,1
2,30,1114.3,525.9,344,1237,1581,2,targOff,1
2,31,938,530.8,1837,-279,1558,1,waiting,1
2,31,752.5,528.2,240,1586,1826,2,targOff,1
2,32,850.3,541.7,450,-283,167,1,waiting,1
2,32,924.3,534.2,875,185,1060,2,waiting,1
2,32,1112.5,536.4,84,1094,1178,3,waiting,1
2,33,911.6,588.6,28,25,53,1,waiting,1
2,33,930.2,544.5,968,63,1031,2,waiting,1
2,34,914.2,520.4,290,-280,10,1,waiting,1
2,34,924.2,539.9,1463,20,1483,2,waiting,1
2,34,1088.1,535.1,498,1516,2014,3,targOff,1
2,35,924.8,541.5,1289,-276,1013,1,waiting,1
2,35,765,542.4,508,1039,1547,2,targOff,1
2,36,923.9,536.9,1666,-34,1632,1,waiting,1
2,36,1078.1,538.4,252,1658,1910,2,targOff,1
2,37,1069.7,546.7,338,-284,54,1,waiting,1
2,37,918.9,546.6,734,80,814,2,waiting,1
2,38,923.5,537,1888,-279,1609,1,waiting,1
2,38,760.5,538.7,339,1640,1979,2,targOff,1
2,39,929.3,544.8,277,-272,5,1,waiting,1
2,39,917.4,536.8,1084,13,1097,2,waiting,1
2,40,920.1,535.4,1847,-275,1572,1,waiting,1
2,40,741.2,541,295,1602,1897,2,targOff,1
2,1,939.6,530.9,2301,-287,2014,1,waiting,2
2,2,930.9,533.6,2053,-273,1780,1,waiting,2
2,3,924.6,533.7,2095,-281,1814,1,waiting,2
2,4,929,525.9,1898,-284,1614,1,waiting,2
2,5,923.6,531,1856,-295,1561,1,waiting,2
2,6,915.8,540.6,1109,-280,829,1,waiting,2
2,7,918.8,542.2,1453,-289,1164,1,waiting,2
2,8,940.3,533.4,280,-271,9,1,waiting,2
2,8,911.4,536.2,815,16,831,2,waiting,2
2,9,919.5,537.3,1321,-274,1047,1,waiting,2
2,10,914.6,514.3,304,-287,17,1,waiting,2
2,10,931.4,534.6,1613,28,1641,2,waiting,2
2,10,927.9,531.5,166,1649,1815,3,targOff,2
2,11,935.3,536.8,2293,-279,2014,1,waiting,2
2,12,930,532.8,2132,-285,1847,1,waiting,2
2,13,931.1,534.9,1839,-25,1814,1,waiting,2
2,14,930.2,536.4,1707,-43,1664,1,waiting,2
2,15,928.3,535.5,1944,-284,1660,1,waiting,2
2,16,921.5,540.7,1950,-286,1664,1,waiting,2
2,17,876.7,535.8,296,-279,17,1,waiting,2
2,17,914.4,532.4,1046,33,1079,2,waiting,2
2,18,916.1,533.2,1322,-275,1047,1,waiting,2
2,19,920,535,1439,-279,1160,1,waiting,2
2,20,908.6,535.5,1161,3,1164,1,waiting,2
2,21,921.3,545.7,1364,20,1384,1,waiting,2
2,21,921.5,527.6,190,1391,1581,2,targOff,2
2,22,922.7,542.1,315,-284,31,1,waiting,2
2,22,936.7,544,1320,40,1360,2,waiting,2
2,22,931.8,532.8,179,1369,1548,3,targOff,2
2,23,928.7,521.8,1921,-145,1776,1,waiting,2
2,24,930.1,540.2,533,-281,252,1,waiting,2
2,24,926.2,525.1,838,343,1181,2,waiting,2
2,25,975,525.2,294,-283,11,1,waiting,2
2,25,918.6,530.8,1091,23,1114,2,waiting,2
2,26,924.8,539.4,1553,2,1555,1,waiting,2
2,26,1073.8,531.5,63,1581,1644,2,targOff,2
2,27,887.8,578.6,139,-123,16,1,waiting,2
2,27,943,544.6,972,38,1010,2,waiting,2
2,27,935.8,553.6,460,1018,1478,3,dotOff,2
2,27,930.8,535.8,260,1487,1747,4,targOff,2
2,28,934,540.5,1607,-33,1574,1,waiting,2
2,28,1086.6,533.1,238,1603,1841,2,targOff,2
2,28,911.2,537.3,80,1867,1947,3,targOff,2
2,29,914.5,517.6,211,-152,59,1,waiting,2
2,29,929.8,535.6,1826,72,1898,2,waiting,2
2,30,928.1,533.1,1680,-2,1678,1,waiting,2
2,31,944.4,533.9,2210,-279,1931,1,waiting,2
2,32,941.2,532.2,1962,-281,1681,1,waiting,2
2,33,924.6,533.5,1835,-283,1552,1,waiting,2
2,33,935.4,529.2,118,1562,1680,2,targOff,2
2,34,930.2,538.1,1913,-282,1631,1,waiting,2
2,35,929,533.3,651,-29,622,1,waiting,2
2,35,926.4,538.3,936,629,1565,2,waiting,2
2,35,927.1,527.1,241,1573,1814,3,targOff,2
2,36,926.9,540.7,1392,-12,1380,1,waiting,2
2,36,920.6,537.4,176,1388,1564,2,targOff,2
2,37,923.1,542.3,506,-58,448,1,waiting,2
2,37,1079.4,542.4,290,474,764,2,waiting,2
2,38,877.1,541.3,291,-277,14,1,waiting,2
2,38,917.1,538.6,954,27,981,2,waiting,2
2,39,915.7,542.8,1510,-280,1230,1,waiting,2
2,40,919,543.9,1111,-280,831,1,waiting,2
2,1,1204.2,525.3,268,-246,22,1,waiting,3
2,1,928.1,539.6,851,63,914,2,waiting,3
2,2,926.1,539.4,1392,-276,1116,1,waiting,3
2,2,726.2,537.7,496,1151,1647,2,targOff,3
2,3,926.2,536.6,1393,-3,1390,1,waiting,3
2,3,773.1,542.9,193,1422,1615,2,targOff,3
2,3,748.6,546.6,307,1623,1930,3,targOff,3
2,4,922.5,536.5,1278,-274,1004,1,waiting,3
2,4,762.2,538.6,513,1034,1547,2,targVis,3
2,5,927.6,539.2,1802,-272,1530,1,waiting,3
2,5,744.3,528.9,367,1564,1931,2,targOff,3
2,6,917.7,531.6,1228,-14,1214,1,waiting,3
2,7,954.3,530.9,188,-161,27,1,waiting,3
2,7,918.8,539.5,1225,35,1260,2,waiting,3
2,7,753,540.1,374,1290,1664,3,targOff,3
2,8,925.5,532.8,1668,-236,1432,1,waiting,3
2,8,1087.1,534,399,1465,1864,2,targOff,3
2,9,913.5,540.5,1228,-280,948,1,waiting,3
2,10,917.9,540.3,1384,-289,1095,1,waiting,3
2,11,906.7,534.5,1287,-273,1014,1,waiting,3
2,12,917.2,542.9,1055,-157,898,1,waiting,3
2,13,913.8,538.2,1074,-277,797,1,waiting,3
2,14,921.5,536.7,1104,-290,814,1,waiting,3
2,15,877.4,514.7,261,-232,29,1,waiting,3
2,15,903.3,534.8,987,43,1030,2,waiting,3
2,16,940.8,537.4,312,-279,33,1,waiting,3
2,16,899.3,537.1,855,42,897,2,waiting,3
2,17,897.6,540.9,288,-281,7,1,waiting,3
2,17,909.3,548.5,962,15,977,2,waiting,3
2,18,911.3,537.5,1046,-282,764,1,waiting,3
2,19,909.5,541.6,1118,-208,910,1,waiting,3
2,20,897.7,526.5,326,-284,42,1,waiting,3
2,20,915,546.7,424,53,477,2,waiting,3
2,20,911.9,536.2,744,487,1231,3,waiting,3
2,21,911.4,541.6,897,-1,896,1,waiting,3
2,22,911.3,550.3,1393,-280,1113,1,waiting,3
2,23,914,543.9,1184,-286,898,1,waiting,3
2,24,910.6,545.6,1198,-284,914,1,waiting,3
2,25,904.4,546.5,1448,-284,1164,1,waiting,3
2,26,917.3,529.8,1072,-274,798,1,waiting,3
2,27,908.6,543.8,1053,-272,781,1,waiting,3
2,28,913,539.5,1495,-281,1214,1,waiting,3
2,29,916.2,537.2,1064,-282,782,1,waiting,3
2,30,908.3,534.2,1244,-281,963,1,waiting,3
2,31,903.5,539.3,1347,-283,1064,1,waiting,3
2,32,905,545.1,1387,-273,1114,1,waiting,3
2,33,901.2,545.9,1451,-287,1164,1,waiting,3
2,34,907.9,541.8,1410,-280,1130,1,waiting,3
2,35,907.6,544.3,1421,-290,1131,1,waiting,3
2,36,928.8,544.4,1733,-2,1731,1,waiting,3
2,37,928.6,545.5,1611,-285,1326,1,waiting,3
2,37,1113,538.1,407,1357,1764,2,targOff,3
2,38,913.9,537,1403,-272,1131,1,waiting,3
2,39,915.2,541.3,1374,-277,1097,1,waiting,3
2,40,917.6,539.9,1172,-158,1014,1,waiting,3
2,1,1003.6,504.1,136,-37,99,1,waiting,4
2,1,949.6,522.8,1561,110,1671,2,waiting,4
2,1,1109.4,516.9,183,1696,1879,3,targOff,4
2,2,1109.9,534.4,541,-271,270,1,waiting,4
2,2,1026.6,531.6,114,291,405,2,waiting,4
2,2,915.6,519.9,143,429,572,3,waiting,4
2,2,955.2,528.5,515,583,1098,4,waiting,4
2,3,943.8,526.8,1809,-282,1527,1,waiting,4
2,3,1119.2,522.8,158,1554,1712,2,targOff,4
2,4,947.5,525.8,1944,-196,1748,1,waiting,4
2,5,941.4,532.1,2125,-278,1847,1,waiting,4
2,6,937.1,534,1992,-279,1713,1,waiting,4
2,7,931.2,532.9,1565,-26,1539,1,waiting,4
2,7,751.1,526.3,176,1571,1747,2,targOff,4
2,8,935.6,530.2,1962,-2,1960,1,waiting,4
2,9,933.5,531.6,1938,-23,1915,1,waiting,4
2,10,930.7,529.6,2001,-20,1981,1,waiting,4
2,11,921.5,530.1,344,-30,314,1,waiting,4
2,11,930.1,526.7,1310,321,1631,2,waiting,4
2,12,917.8,530.5,301,-283,18,1,waiting,4
2,12,941,529.5,415,27,442,2,waiting,4
2,12,928.1,526.7,1480,450,1930,3,waiting,4
2,13,932.6,526.3,1972,-242,1730,1,waiting,4
2,14,922.7,531.1,1799,-285,1514,1,waiting,4
2,15,929.7,526.6,2085,-287,1798,1,waiting,4
2,16,928.4,534.1,2273,-279,1994,1,waiting,4
2,17,904.2,549.3,324,-274,50,1,waiting,4
2,17,923.4,527.5,1669,62,1731,2,waiting,4
2,18,931.1,531.3,1928,-143,1785,1,waiting,4
2,18,933.1,527.2,166,1798,1964,2,targOff,4
2,19,934.3,536.5,1924,-279,1645,1,waiting,4
2,20,931.7,528.4,2259,-278,1981,1,waiting,4
2,21,929.8,547.4,301,-296,5,1,waiting,4
2,21,934.8,526.5,1647,13,1660,2,waiting,4
2,22,930.5,528.2,1843,1,1844,1,waiting,4
2,23,933.3,532.5,1600,-23,1577,1,waiting,4
2,24,927.5,532.4,1845,-132,1713,1,waiting,4
2,25,923.6,536.8,1909,-278,1631,1,waiting,4
2,26,947.3,569.4,299,-280,19,1,waiting,4
2,26,926.3,533.8,1965,32,1997,2,waiting,4
2,27,923.7,533.2,2180,-282,1898,1,waiting,4
2,28,902,531,287,-275,12,1,waiting,4
2,28,925.9,528.6,1743,21,1764,2,waiting,4
2,29,932,539.1,2060,-280,1780,1,waiting,4
2,30,925.3,533.1,1806,-292,1514,1,waiting,4
2,31,929.5,531,1979,-266,1713,1,waiting,4
2,32,930.4,535.4,1901,-288,1613,1,waiting,4
2,33,930.8,533.4,1932,-285,1647,1,waiting,4
2,34,924.9,540.9,1717,-39,1678,1,waiting,4
2,35,923.5,537.6,1704,10,1714,1,waiting,4
2,36,926.1,532.5,1879,-281,1598,1,waiting,4
2,37,935.3,540.1,1476,-22,1454,1,waiting,4
2,37,915.6,536.4,100,1464,1564,2,targOff,4
2,38,931.4,536.7,1608,-26,1582,1,waiting,4
2,39,934.6,541.6,935,-287,648,1,waiting,4
2,39,1084.3,539.4,373,674,1047,2,waiting,4
2,40,925.1,530.1,2228,-280,1948,1,waiting,4
2,1,1049.3,528.6,445,-273,172,1,waiting,5
2,1,943.7,538.8,1200,189,1389,2,waiting,5
2,1,1123.2,522.9,489,1425,1914,3,targOff,5
2,2,943.9,536.9,1309,-124,1185,1,waiting,5
2,2,775.8,537.6,486,1211,1697,2,targOff,5
2,3,929.6,535.9,1392,-172,1220,1,waiting,5
2,3,1100,528.1,503,1245,1748,2,targOff,5
2,4,930.2,534.9,558,-11,547,1,waiting,5
2,4,928.6,525.8,510,556,1066,2,waiting,5
2,4,1101.5,527.2,382,1099,1481,3,targOff,5
2,5,937.3,526,1453,1,1454,1,waiting,5
2,5,1113.8,534.3,474,1487,1961,2,targOff,5
2,6,939.5,534,1469,-280,1189,1,waiting,5
2,6,1109.1,532.1,443,1219,1662,2,targOff,5
2,7,924.2,540.1,1468,-286,1182,1,waiting,5
2,8,926.2,536.5,1465,-283,1182,1,waiting,5
2,8,734.7,538.4,415,1216,1631,2,targOff,5
2,9,927.6,528.8,1568,-296,1272,1,waiting,5
2,9,1093.7,527.8,229,1298,1527,2,targOff,5
2,10,914.3,535.7,211,-4,207,1,waiting,5
2,10,932.1,533.2,846,216,1062,2,waiting,5
2,10,1149.1,523.5,103,1098,1201,3,targOff,5
2,10,1083.7,524.4,379,1219,1598,4,targOff,5
2,11,919.5,538.2,178,4,182,1,waiting,5
2,11,924,532.9,1058,191,1249,2,waiting,5
2,11,1112,515.3,314,1284,1598,3,targOff,5
2,12,928.1,533.7,1194,0,1194,1,waiting,5
2,12,1082.5,530.6,298,1216,1514,2,targOff,5
2,13,941.1,536.1,236,-179,57,1,waiting,5
2,13,947.5,534.9,158,67,225,2,waiting,5
2,13,939.3,525.5,1048,233,1281,3,waiting,5
2,13,1115.7,527.8,455,1309,1764,4,targOff,5
2,14,943.8,534.4,1694,-27,1667,1,waiting,5
2,14,1120.2,529,237,1707,1944,2,targOff,5
2,15,941,538.4,1474,-31,1443,1,waiting,5
2,15,1126.4,535.3,254,1477,1731,2,targOff,5
2,16,935,542.5,1541,2,1543,1,waiting,5
2,16,715.2,536.9,235,1580,1815,2,targOff,5
2,17,934.5,536.5,1227,19,1246,1,waiting,5
2,17,1106.1,529.4,389,1275,1664,2,targOff,5
2,18,935.1,535.8,1667,-273,1394,1,waiting,5
2,18,746.9,538.1,453,1428,1881,2,targOff,5
2,19,878.5,542.2,337,-280,57,1,waiting,5
2,19,856,549.1,149,65,214,2,waiting,5
2,19,932.9,529.9,892,234,1126,3,waiting,5
2,20,923.3,537.1,1614,-280,1334,1,waiting,5
2,20,747.9,535.2,302,1362,1664,2,targOff,5
2,21,937.3,537.1,1667,-280,1387,1,waiting,5
2,21,1110.7,541.6,500,1415,1915,2,targOff,5
2,22,933.6,538.4,1884,-285,1599,1,waiting,5
2,22,770.9,537.9,201,1630,1831,2,targOff,5
2,23,915.2,531.9,310,-289,21,1,waiting,5
2,23,927.3,532.7,1645,30,1675,2,waiting,5
2,23,1100.2,529.8,236,1711,1947,3,targOff,5
2,24,936.6,530.1,1778,-283,1495,1,waiting,5
2,24,1192.3,531.9,79,1534,1613,2,targOff,5
2,24,1102.8,536.5,111,1636,1747,3,targOff,5
2,25,926.8,536.6,1326,14,1340,1,waiting,5
2,25,1089.4,530,298,1366,1664,2,targOff,5
2,26,907.2,532.1,305,-281,24,1,waiting,5
2,26,919.2,536.7,945,36,981,2,waiting,5
2,27,856.7,537.3,293,-281,12,1,waiting,5
2,27,919.4,536.7,174,32,206,2,waiting,5
2,27,928.9,532.2,1020,217,1237,3,waiting,5
2,27,1098.7,521.3,322,1274,1596,4,targOff,5
2,28,966.6,529.7,208,-174,34,1,waiting,5
2,28,930.2,533.9,626,44,670,2,waiting,5
2,28,926.8,523.7,481,678,1159,3,waiting,5
2,28,749.8,531.8,286,1195,1481,4,targOff,5
2,29,932.6,537.9,1237,10,1247,1,waiting,5
2,29,761.7,526.3,284,1280,1564,2,targOff,5
2,30,933.8,532.4,1636,-281,1355,1,waiting,5
2,30,1102.8,530.9,498,1395,1893,2,targOff,5
2,31,1000.2,535.2,228,-222,6,1,waiting,5
2,31,933.8,527.2,1182,24,1206,2,waiting,5
2,31,1124.7,522.3,355,1242,1597,3,targOff,5
2,32,950.2,536.1,181,-6,175,1,waiting,5
2,32,932.5,532.2,832,183,1015,2,waiting,5
2,32,742.5,528.9,542,1051,1593,3,targVis,5
2,33,966.3,529,440,-273,167,1,waiting,5
2,33,926.5,529.6,1286,181,1467,2,waiting,5
2,33,758,528.2,416,1498,1914,3,targOff,5
2,34,927.8,531.4,1385,-85,1300,1,waiting,5
2,34,779.2,529.9,156,1326,1482,2,targVis,5
2,34,749.4,537.1,379,1501,1880,3,targOff,5
2,35,902.4,539.1,291,-279,12,1,waiting,5
2,35,924.3,536.4,1646,25,1671,2,waiting,5
2,35,750.7,523.4,258,1706,1964,3,targOff,5
2,36,940.8,529.8,383,-277,106,1,waiting,5
2,36,921.3,532.9,1016,115,1131,2,waiting,5
2,36,1105.4,541.2,598,1166,1764,3,dotOff,5
2,37,960,548,259,-218,41,1,waiting,5
2,37,922.5,533.5,1185,53,1238,2,waiting,5
2,37,1107.2,529,310,1270,1580,3,targOff,5
2,38,918.7,528.2,237,-190,47,1,waiting,5
2,38,925.5,538.6,1100,55,1155,2,waiting,5
2,38,1077.1,534.3,617,1180,1797,3,dotOff,5
2,39,903.5,530.9,303,-279,24,1,waiting,5
2,39,930,540,1384,38,1422,2,waiting,5
2,39,1088.7,533.9,599,1447,2046,3,dotOff,5
2,40,1023.1,509,326,-281,45,1,waiting,5
2,40,942.5,533.7,1153,67,1220,2,waiting,5
2,40,1126,530.2,427,1254,1681,3,targOff,5
2,1,1229.8,500.2,601,-280,321,1,waiting,6
2,1,1113.1,522.7,229,342,571,2,waiting,6
2,1,1101.5,528.1,126,662,788,3,waiting,6
2,1,1122.3,528.9,87,893,980,4,waiting,6
2,2,950.6,532.4,2006,-9,1997,1,waiting,6
2,3,946.7,523.7,1869,-272,1597,1,waiting,6
2,4,954.4,523.7,1966,-122,1844,1,waiting,6
2,5,951.6,539.9,2330,-282,2048,1,waiting,6
2,6,940,530.5,2102,-38,2064,1,waiting,6
2,7,945.1,530.9,2351,-286,2065,1,waiting,6
2,8,927.9,530,276,-273,3,1,waiting,6
2,8,943.4,531.6,1987,11,1998,2,waiting,6
2,9,951.5,534.7,1767,-48,1719,1,waiting,6
2,9,972.3,523,47,1729,1776,2,targOff,6
2,10,958.2,542.4,1076,-288,788,1,waiting,6
2,10,947.3,537.2,1198,800,1998,2,waiting,6
2,11,949.1,533.4,2023,-25,1998,1,waiting,6
2,12,946,538.7,2261,-200,2061,1,waiting,6
2,13,952.5,539.6,1925,-278,1647,1,waiting,6
2,14,946.4,541.9,1760,-287,1473,1,waiting,6
2,14,950.2,529.5,115,1482,1597,2,targOff,6
2,15,946.5,539.7,486,-271,215,1,waiting,6
2,15,953.9,540.8,1525,223,1748,2,waiting,6
2,16,941.1,536.6,2208,-280,1928,1,waiting,6
2,17,938.6,534.7,1674,-42,1632,1,waiting,6
2,18,938.6,538.6,1697,-20,1677,1,waiting,6
2,19,939.2,538.3,2362,-282,2080,1,waiting,6
2,20,934.2,533.4,1994,4,1998,1,waiting,6
2,21,931.4,534.8,2287,-273,2014,1,waiting,6
2,22,934.4,524.3,1902,-271,1631,1,waiting,6
2,23,935,530.9,284,-9,275,1,waiting,6
2,23,1090.6,524.8,192,302,494,2,waiting,6
2,23,942.5,525.2,545,519,1064,3,waiting,6
2,24,995.8,532.7,324,-287,37,1,waiting,6
2,24,930.2,535.5,1580,51,1631,2,waiting,6
2,25,935.8,529.4,1662,2,1664,1,waiting,6
2,26,920.4,529.9,520,-286,234,1,waiting,6
2,26,945,537.5,253,244,497,2,waiting,6
2,26,930.7,534.2,1491,506,1997,3,waiting,6
2,27,931.8,530.7,2010,-280,1730,1,waiting,6
2,28,921.3,535.9,377,-277,100,1,waiting,6
2,28,930.2,532.3,1945,119,2064,2,waiting,6
2,29,936.6,537.1,1873,-27,1846,1,waiting,6
2,30,942.3,533.3,1842,-111,1731,1,waiting,6
2,31,952.4,539.3,270,1,271,1,waiting,6
2,31,863.1,534.5,326,290,616,2,waiting,6
2,31,948.2,529.7,409,639,1048,3,waiting,6
2,31,943.9,525.6,752,1056,1808,4,waiting,6
2,31,770.6,528.2,154,1843,1997,5,targOff,6
2,32,955.1,539.1,221,-11,210,1,waiting,6
2,32,945.1,538,270,218,488,2,waiting,6
2,32,942.9,534,1385,496,1881,3,waiting,6
2,33,945.5,530.9,349,-6,343,1,waiting,6
2,33,941.3,525.8,1345,352,1697,2,waiting,6
2,34,936.6,557.4,166,-112,54,1,waiting,6
2,34,945.8,535.9,588,75,663,2,waiting,6
2,34,923.1,535.6,163,676,839,3,waiting,6
2,34,924.6,523.5,198,913,1111,4,waiting,6
2,34,941,551.2,656,1124,1780,5,dotOff,6
2,35,958.3,549.3,1790,-26,1764,1,waiting,6
2,36,945.4,533.7,1089,-34,1055,1,waiting,6
2,36,961,520.4,180,1067,1247,2,dotOff,6
2,36,1100.5,533.9,294,1275,1569,3,dotOff,6
2,36,900.1,533.6,207,1619,1826,4,targOff,6
2,36,930,533.9,43,1837,1880,5,targOff,6
2,37,871,544.7,363,-294,69,1,waiting,6
2,37,929.8,543.3,169,93,262,2,waiting,6
2,37,818.8,539.1,166,302,468,3,waiting,6
2,37,756.8,550.6,265,488,753,4,waiting,6
2,37,930.9,541.9,164,780,944,5,waiting,6
2,38,875,579.3,167,324,491,1,waiting,6
2,38,952.7,546.7,141,518,659,2,waiting,6
2,38,796.3,550.1,127,687,814,3,waiting,6
2,39,941.7,547.1,223,-171,52,1,waiting,6
2,39,955.8,536.2,276,74,350,2,waiting,6
2,39,946.1,535,1286,361,1647,3,waiting,6
2,39,940.6,516.3,205,1659,1864,4,targOff,6
2,40,948,528.8,1857,-10,1847,1,waiting,6
2,1,964.4,511.5,1742,-282,1460,1,waiting,7
2,1,1107.5,526.9,563,1483,2046,2,targVis,7
2,2,987.9,519.2,220,-198,22,1,waiting,7
2,2,941.9,531.5,1724,30,1754,2,waiting,7
2,2,772.8,512,295,1785,2080,3,targOff,7
2,3,951.5,533,1754,-26,1728,1,waiting,7
2,3,775.1,517,222,1758,1980,2,targOff,7
2,4,924.9,518.5,145,-118,27,1,waiting,7
2,4,946.6,532.4,1928,36,1964,2,waiting,7
2,5,977.2,526.5,159,309,468,1,waiting,7
2,5,942.5,522.7,555,492,1047,2,waiting,7
2,6,930.5,513.8,295,-272,23,1,waiting,7
2,6,946.1,526,1098,32,1130,2,waiting,7
2,6,1116.2,532.6,826,1155,1981,3,dotOff,7
2,7,971.7,523.5,194,5,199,1,waiting,7
2,7,937.2,527.3,1074,210,1284,2,waiting,7
2,7,752.5,524,748,1316,2064,3,dotOff,7
2,8,935.8,524,1651,-282,1369,1,waiting,7
2,8,1120,531.1,524,1406,1930,2,targVis,7
2,9,935.9,544.8,304,-279,25,1,waiting,7
2,9,938.9,532.8,1875,35,1910,2,waiting,7
2,10,947.1,540.3,343,-288,55,1,waiting,7
2,10,940.4,528.1,1275,63,1338,2,waiting,7
2,10,1099.4,526.5,602,1363,1965,3,dotOff,7
2,11,1121.9,-486.6,30,242,272,1,waiting,7
2,11,1131.9,-481.1,46,480,526,2,waiting,7
2,11,938.6,538.8,271,776,1047,3,waiting,7
2,12,950.8,535.8,1598,-273,1325,1,waiting,7
2,12,750.8,526.6,484,1363,1847,2,targOff,7
2,13,944.1,530.8,1538,-271,1267,1,waiting,7
2,13,780.9,531.3,804,1294,2098,2,dotOff,7
2,14,944.5,537.9,1411,-285,1126,1,waiting,7
2,14,757,537.4,657,1158,1815,2,dotOff,7
2,15,936.8,527.1,1431,-4,1427,1,waiting,7
2,15,741.1,527.8,703,1461,2164,2,dotOff,7
2,16,929.8,527.9,1544,-278,1266,1,waiting,7
2,16,1105.1,536.2,677,1304,1981,2,dotOff,7
2,17,928.8,522.6,1532,-278,1254,1,waiting,7
2,17,1089.1,516.3,658,1288,1946,2,dotOff,7
2,18,949.9,531.2,1652,-34,1618,1,waiting,7
2,18,1120.1,534,304,1644,1948,2,targOff,7
2,19,940.3,522.6,1699,-288,1411,1,waiting,7
2,19,754.4,538.8,708,1439,2147,2,dotOff,7
2,20,974.8,516.3,279,-278,1,1,waiting,7
2,20,930.6,524.8,1162,11,1173,2,waiting,7
2,20,1102.9,523.7,533,1197,1730,3,targVis,7
2,21,935.1,524.6,1463,-20,1443,1,waiting,7
2,21,767.1,521.5,416,1475,1891,2,dotOff,7
2,21,749.9,519.6,180,1900,2080,3,targOff,7
2,22,933.9,523.8,1446,-285,1161,1,waiting,7
2,22,1112.1,528.5,679,1186,1865,2,dotOff,7
2,23,934.9,538.9,765,10,775,1,waiting,7
2,23,914.2,530.3,165,783,948,2,waiting,7
2,23,939.6,533.8,400,956,1356,3,waiting,7
2,23,750.4,534.1,516,1389,1905,4,dotOff,7
2,23,752.9,525,250,1914,2164,5,targOff,7
2,24,932.4,529.8,1818,-278,1540,1,waiting,7
2,24,783.3,525.8,394,1570,1964,2,targOff,7
2,25,940.7,523.9,1359,1,1360,1,waiting,7
2,25,765.7,530.4,371,1393,1764,2,targOff,7
2,26,948.2,523.8,263,-24,239,1,waiting,7
2,26,940.7,541.3,1174,252,1426,2,waiting,7
2,26,1117.7,535.1,537,1460,1997,3,dotOff,7
2,26,962.6,530.2,218,2024,2242,4,targOff,7
2,27,934.3,534,1120,21,1141,1,waiting,7
2,27,756.7,525.6,742,1172,1914,2,dotOff,7
2,28,940.5,538.6,1909,-223,1686,1,waiting,7
2,28,1128.3,539.6,503,1712,2215,2,targOff,7
2,29,933.9,534.6,1713,-285,1428,1,waiting,7
2,29,1117.9,535.7,573,1454,2027,2,dotOff,7
2,29,1101.4,531.8,162,2035,2197,3,targOff,7
2,30,968.5,525,311,-277,34,1,waiting,7
2,30,932.4,538.8,1065,45,1110,2,waiting,7
2,30,1111.7,541.6,703,1145,1848,3,dotOff,7
2,31,937.9,534.7,2103,-273,1830,1,waiting,7
2,31,800.8,539.3,111,1853,1964,2,targOff,7
2,32,944.6,537.4,1481,-282,1199,1,waiting,7
2,32,1118.6,536.9,555,1226,1781,2,targVis,7
2,33,937.8,528,1524,-50,1474,1,waiting,7
2,33,755.9,527.3,356,1508,1864,2,targOff,7
2,34,924.6,535.6,1425,7,1432,1,waiting,7
2,34,746.7,537.1,314,1466,1780,2,targOff,7
2,35,926.5,536.8,1662,-283,1379,1,waiting,7
2,35,758.4,530.9,335,1412,1747,2,targOff,7
2,36,932.4,540.3,1645,-276,1369,1,waiting,7
2,36,773.3,530,495,1402,1897,2,targOff,7
2,37,903.2,541.6,191,-136,55,1,waiting,7
2,37,944.8,533.9,2126,72,2198,2,waiting,7
2,38,941,532.5,1408,-285,1123,1,waiting,7
2,38,1121.2,533.5,745,1152,1897,2,dotOff,7
2,39,938.5,532.2,1511,-6,1505,1,waiting,7
2,39,777.9,538.6,653,1529,2182,2,dotOff,7
2,40,939.2,533.5,1669,-288,1381,1,waiting,7
2,40,1114.3,535.7,515,1417,1932,2,targVis,7
2,1,1202.6,485.6,504,-279,225,1,waiting,8
2,1,975,525.6,142,264,406,2,waiting,8
2,1,945.9,534.4,361,417,778,3,waiting,8
2,2,953.3,517.8,1934,-278,1656,1,waiting,8
2,2,771.5,514.8,257,1688,1945,2,targOff,8
2,3,948,536.1,686,527,1213,1,waiting,8
2,4,939.2,523.9,460,-272,188,1,waiting,8
2,4,939.7,526,1636,195,1831,2,waiting,8
2,5,943.9,522.8,1306,-280,1026,1,waiting,8
2,5,942.6,523,667,1036,1703,2,dotOff,8
2,5,938.2,516.1,216,1712,1928,3,targOff,8
2,6,944,519.9,1861,-14,1847,1,waiting,8
2,7,950.8,527.8,2253,-173,2080,1,waiting,8
2,8,951.3,515,2189,-191,1998,1,waiting,8
2,9,948,537.3,2042,-45,1997,1,waiting,8
2,10,944,525.9,2435,-271,2164,1,waiting,8
2,11,937.8,523.9,2412,-281,2131,1,waiting,8
2,12,946.7,534.7,2326,-281,2045,1,waiting,8
2,13,944.4,533.3,2468,-288,2180,1,waiting,8
2,14,949,529.9,1759,6,1765,1,waiting,8
2,14,936.2,541.6,123,1774,1897,2,targOff,8
2,15,946.9,533.4,1664,-39,1625,1,waiting,8
2,15,933.7,527.7,131,1633,1764,2,targOff,8
2,16,944,533.1,2076,-278,1798,1,waiting,8
2,17,944.7,532.8,2297,-283,2014,1,waiting,8
2,18,946.3,536.5,2399,-284,2115,1,waiting,8
2,19,941.3,527.2,2054,-43,2011,1,waiting,8
2,20,942.3,528.4,2038,-294,1744,1,waiting,8
2,21,944.2,541.6,641,-280,361,1,waiting,8
2,21,939.6,538.2,1611,368,1979,2,waiting,8
2,22,939.5,531.6,2354,-290,2064,1,waiting,8
2,23,941.9,535.6,2134,-285,1849,1,waiting,8
2,23,918.8,528.9,122,1859,1981,2,targOff,8
2,24,944.2,534.9,2435,-286,2149,1,waiting,8
2,25,941.8,533.5,2049,-285,1764,1,waiting,8
2,26,947.4,523.2,2149,-286,1863,1,waiting,8
2,27,938.7,532.2,2178,-281,1897,1,waiting,8
2,28,945,530.1,2422,-295,2127,1,waiting,8
2,29,938.9,541.8,586,-287,299,1,waiting,8
2,29,944.8,539.5,1558,306,1864,2,waiting,8
2,30,941.3,530.4,2151,-287,1864,1,waiting,8
2,31,945.8,532.3,2046,-37,2009,1,waiting,8
2,31,932.8,526.4,127,2016,2143,2,targOff,8
2,32,945.7,536.2,922,-287,635,1,waiting,8
2,32,949.7,531.1,1320,644,1964,2,waiting,8
2,33,951.2,533.4,2052,-57,1995,1,waiting,8
2,34,942.9,532.3,2178,-280,1898,1,waiting,8
2,35,949.8,542.6,1963,-232,1731,1,waiting,8
2,36,946.9,546.5,221,-20,201,1,waiting,8
2,36,949.6,534.4,1856,208,2064,2,waiting,8
2,37,957,522.5,1421,-269,1152,1,waiting,8
2,37,1126.4,523.9,508,1179,1687,2,dotOff,8
2,37,956.4,533.9,210,1721,1931,3,targOff,8
2,38,930.3,535.5,456,-288,168,1,waiting,8
2,38,940.7,529.2,671,182,853,2,waiting,8
2,38,947.9,528.2,1314,866,2180,3,waiting,8
2,39,952.7,524.9,1782,-1,1781,1,waiting,8
2,40,959.9,551.1,714,-5,709,1,waiting,8
2,40,954.8,535.6,1331,717,2048,2,waiting,8
2,1,1170.2,521.4,434,-289,145,1,waiting,9
2,1,905,509.5,152,182,334,2,waiting,9
2,1,955.3,524.1,834,347,1181,3,waiting,9
2,2,954.3,523.3,1354,-284,1070,1,waiting,9
2,2,955.6,521.7,330,1080,1410,2,waiting,9
2,2,753.8,524.3,635,1446,2081,3,dotOff,9
2,3,1020.9,533.5,301,-279,22,1,waiting,9
2,3,957.9,535.4,1716,36,1752,2,waiting,9
2,3,780.7,527.3,215,1781,1996,3,targOff,9
2,4,955.1,535.9,1407,-281,1126,1,waiting,9
2,4,1126.9,535,845,1152,1997,2,dotOff,9
2,5,964.2,530.8,1801,-287,1514,1,waiting,9
2,5,1146.5,521,448,1549,1997,2,targOff,9
2,6,955.9,534.2,1844,-278,1566,1,waiting,9
2,6,759,526.9,304,1603,1907,2,targOff,9
2,6,789,526.5,47,1915,1962,3,targOff,9
2,7,955,538.8,1550,-78,1472,1,waiting,9
2,7,1120.2,527.8,579,1501,2080,2,dotOff,9
2,8,943.5,535.4,1821,-51,1770,1,waiting,9
2,8,771.2,535.4,359,1804,2163,2,targOff,9
2,9,949.1,535,1660,-297,1363,1,waiting,9
2,9,783.8,539.6,815,1394,2209,2,dotOff,9
2,10,927.8,551.9,449,-109,340,1,waiting,9
2,10,972.9,538.6,217,351,568,2,waiting,9
2,10,931.2,549.5,519,580,1099,3,waiting,9
2,10,927.7,546.6,295,1231,1526,4,dotOff,9
2,10,741.2,541.6,201,1726,1927,5,targOff,9
2,11,930.8,543.3,315,-287,28,1,waiting,9
2,11,945,530.8,955,36,991,2,waiting,9
2,11,1122,524.8,811,1020,1831,3,dotOff,9
2,12,948.7,532,1440,-285,1155,1,waiting,9
2,12,936,535.6,656,1164,1820,2,waiting,9
2,12,1102.6,534.6,301,1845,2146,3,targOff,9
2,13,943.4,531.4,1298,5,1303,1,waiting,9
2,13,1124.4,535.4,768,1330,2098,2,dotOff,9
2,14,945.3,529.9,1641,-285,1356,1,waiting,9
2,14,1121.8,533.4,748,1383,2131,2,dotOff,9
2,15,926.4,514.9,143,-125,18,1,waiting,9
2,15,951.9,538.3,339,28,367,2,waiting,9
2,15,943,529.5,1330,375,1705,3,waiting,9
2,15,1124.9,522.2,309,1739,2048,4,targOff,9
2,16,948.7,534.5,1333,-297,1036,1,waiting,9
2,16,777.9,539.5,678,1065,1743,2,dotOff,9
2,17,953,529.6,1623,-286,1337,1,waiting,9
2,17,1128.4,523.7,639,1375,2014,2,dotOff,9
2,18,949.8,520.7,558,-153,405,1,waiting,9
2,18,947.6,523.7,929,415,1344,2,waiting,9
2,18,1121.4,524,553,1377,1930,3,targVis,9
2,19,936.8,529.4,1768,-276,1492,1,waiting,9
2,19,774,528.7,243,1521,1764,2,targOff,9
2,20,941,528.9,1653,-286,1367,1,waiting,9
2,20,774.8,519.3,252,1396,1648,2,targOff,9
2,21,936.1,546.7,188,-69,119,1,waiting,9
2,21,941.8,538.6,1156,127,1283,2,waiting,9
2,21,779.6,533.6,401,1312,1713,3,dotOff,9
2,21,754,531.2,226,1722,1948,4,targOff,9
2,22,758.5,540,251,-233,18,1,waiting,9
2,22,939.2,532,963,54,1017,2,waiting,9
2,22,1129.9,533,689,1055,1744,3,dotOff,9
2,23,947.3,531.3,1587,-279,1308,1,waiting,9
2,23,763.2,525.2,569,1343,1912,2,dotOff,9
2,24,939.9,532.5,1655,-282,1373,1,waiting,9
2,24,774.9,526.4,631,1399,2030,2,dotOff,9
2,25,949,533.5,1894,-287,1607,1,waiting,9
2,25,1125.6,529.8,297,1635,1932,2,targOff,9
2,26,1062.3,533,330,-286,44,1,waiting,9
2,26,943.7,528.8,1235,66,1301,2,waiting,9
2,26,770.1,531.3,621,1326,1947,3,dotOff,9
2,27,904,529.1,274,-273,1,1,waiting,9
2,27,946.2,525.7,815,24,839,2,waiting,9
2,27,949.5,526.4,567,849,1416,3,waiting,9
2,27,761.4,527.4,348,1449,1797,4,targOff,9
2,28,943,528.9,1654,-51,1603,1,waiting,9
2,28,759.8,525.1,348,1633,1981,2,targOff,9
2,29,892.9,541.6,322,-278,44,1,waiting,9
2,29,936.7,539.4,1189,58,1247,2,waiting,9
2,29,784.7,533.1,367,1276,1643,3,targOff,9
2,30,952.1,529,1259,-136,1123,1,waiting,9
2,30,1121.7,533.6,649,1149,1798,2,dotOff,9
2,31,943.4,527,1312,-279,1033,1,waiting,9
2,31,766.2,524.1,496,1066,1562,2,targOff,9
2,32,930.2,525.1,1392,-47,1345,1,waiting,9
2,32,776.1,528.8,425,1369,1794,2,dotOff,9
2,32,754,526.9,176,1805,1981,3,targOff,9
2,33,892.4,536.5,149,-116,33,1,waiting,9
2,33,945.9,538.9,1547,51,1598,2,waiting,9
2,34,932.8,535.6,708,-286,422,1,waiting,9
2,34,1115.9,536.5,478,448,926,2,waiting,9
2,34,938.1,529.1,62,952,1014,3,waiting,9
2,35,943.5,541.6,1688,-280,1408,1,waiting,9
2,35,767.6,540.2,548,1434,1982,2,targVis,9
2,36,952,543,1540,-42,1498,1,waiting,9
2,36,1124,535.4,231,1533,1764,2,targOff,9
2,37,939.6,537.7,1679,-280,1399,1,waiting,9
2,37,1115.4,526.5,588,1426,2014,2,dotOff,9
2,38,938.2,531.7,2019,-283,1736,1,waiting,9
2,38,1080.8,529.5,154,1760,1914,2,targOff,9
2,39,951.2,537.2,178,28,206,1,waiting,9
2,39,930.4,529.2,918,213,1131,2,waiting,9
2,39,783.8,527.2,453,1161,1614,3,targOff,9
2,40,960.4,532.8,152,-55,97,1,waiting,9
2,40,937,532.1,1050,107,1157,2,waiting,9
2,40,755.7,532.1,462,1185,1647,3,targOff,9
2,1,1088.8,520.1,369,-202,167,1,waiting,10
2,1,945,530,1819,191,2010,2,waiting,10
2,2,945.9,535.3,2002,-288,1714,1,waiting,10
2,3,948,531.7,2018,-271,1747,1,waiting,10
2,4,939.3,528.3,1827,-279,1548,1,waiting,10
2,5,964.4,524.4,298,-272,26,1,waiting,10
2,5,941.7,529.1,1797,34,1831,2,waiting,10
2,6,949.8,546,1984,-3,1981,1,waiting,10
2,7,939,530.8,1994,-13,1981,1,waiting,10
2,8,938.6,531.1,1966,-285,1681,1,waiting,10
2,8,947.9,515.7,56,1691,1747,2,targOff,10
2,9,946.2,530.6,1700,-36,1664,1,waiting,10
2,10,931.7,497.6,187,-104,83,1,waiting,10
2,10,941.3,530.6,1754,93,1847,2,waiting,10
2,11,942.2,540.8,1957,-277,1680,1,waiting,10
2,12,940.7,532.1,2067,-273,1794,1,waiting,10
2,12,954.8,532.6,30,1801,1831,2,targOff,10
2,13,954.2,513.5,271,-115,156,1,waiting,10
2,13,939.7,535,1539,165,1704,2,waiting,10
2,13,946.8,536.1,165,1712,1877,3,targOff,10
2,14,943.2,526.8,1929,-1,1928,1,waiting,10
2,15,952.4,537,800,-285,515,1,waiting,10
2,15,948.3,529.8,1391,523,1914,2,waiting,10
2,16,934.8,528,1946,-282,1664,1,waiting,10
2,17,942.3,523.6,2088,-274,1814,1,waiting,10
2,18,939.6,532.9,2092,-95,1997,1,waiting,10
2,19,943.2,531.4,1887,-239,1648,1,waiting,10
2,20,936.5,537.1,1789,-26,1763,1,waiting,10
2,20,930.5,522.6,72,1772,1844,2,targOff,10
2,21,954.8,553.2,149,-102,47,1,waiting,10
2,21,936.6,535.5,436,55,491,2,waiting,10
2,21,1108.1,536.7,207,516,723,3,waiting,10
2,21,933.5,533,380,750,1130,4,waiting,10
2,22,915.2,537.8,332,-279,53,1,waiting,10
2,22,940.5,540.9,1641,61,1702,2,waiting,10
2,22,950.1,529.9,38,1710,1748,3,targOff,10
2,23,944.5,534.2,1895,-13,1882,1,waiting,10
2,24,936.1,532.5,1569,12,1581,1,waiting,10
2,25,939.2,541.8,2029,-199,1830,1,waiting,10
2,26,919,540.1,159,-67,92,1,waiting,10
2,26,888.6,541,195,293,488,2,waiting,10
2,26,934.8,537.5,344,502,846,3,waiting,10
2,27,869.6,541,304,-275,29,1,waiting,10
2,27,931.1,529.5,1652,46,1698,2,waiting,10
2,28,937.2,525.8,2185,-288,1897,1,waiting,10
2,29,932.7,527.1,1899,-285,1614,1,waiting,10
2,30,938.3,527.2,1975,-279,1696,1,waiting,10
2,31,952.2,548.4,1840,-278,1562,1,waiting,10
2,32,976.2,564,343,-286,57,1,waiting,10
2,32,955.6,547.9,158,66,224,2,waiting,10
2,32,833.6,523.4,170,252,422,3,waiting,10
2,32,790,530.4,167,435,602,4,waiting,10
2,32,940.7,522.2,208,629,837,5,waiting,10
2,32,957.3,524.4,266,848,1114,6,waiting,10
2,33,1021.5,535.6,330,-273,57,1,waiting,10
2,33,954.5,530,1470,71,1541,2,waiting,10
2,33,960.7,528.4,315,1549,1864,3,targOff,10
2,34,951,538.3,289,-280,9,1,waiting,10
2,34,946.3,531.1,1980,18,1998,2,waiting,10
2,35,939.3,526.5,1943,-279,1664,1,waiting,10
2,36,943,525.6,1856,-279,1577,1,waiting,10
2,37,934.6,530.6,2276,-278,1998,1,waiting,10
2,38,927.2,538.6,1934,-20,1914,1,waiting,10
2,39,948.6,541.5,303,-11,292,1,waiting,10
2,39,947.7,552.2,33,311,344,2,waiting,10
2,39,933.7,545.2,644,399,1043,3,waiting,10
2,39,936.2,570.1,19,1053,1072,4,targVis,10
2,39,937.2,577.5,231,1111,1342,5,targOff,10
2,39,922.7,546.5,206,1391,1597,6,targOff,10
2,40,928.3,531.4,578,-67,511,1,waiting,10
2,40,937.6,514.5,1182,582,1764,2,waiting,10
2,1,909,547.9,288,-285,3,1,waiting,11
2,1,969.5,535.5,1055,21,1076,2,waiting,11
2,1,1139.3,513.8,489,1109,1598,3,targOff,11
2,2,956.6,518.6,1648,-274,1374,1,waiting,11
2,2,1118.1,517.1,515,1399,1914,2,targVis,11
2,3,955.6,528.8,1962,-271,1691,1,waiting,11
2,3,1117.4,524.3,132,1716,1848,2,targOff,11
2,4,948.3,521.4,817,114,931,1,waiting,11
2,5,957.2,537.3,245,580,825,1,waiting,11
2,5,933.3,519.4,378,834,1212,2,waiting,11
2,6,944.1,530.2,1565,-282,1283,1,waiting,11
2,6,1105.9,510,222,1309,1531,2,targOff,11
2,7,814,-438.6,62,151,213,1,waiting,11
2,7,795,-438.7,26,277,303,2,waiting,11
2,8,938.5,537.5,1237,-281,956,1,waiting,11
2,8,718.9,-482.8,42,1590,1632,2,targOff,11
2,9,955.3,646.8,157,206,363,1,waiting,11
2,9,924.2,524.5,136,391,527,2,waiting,11
2,9,963.9,540.5,598,546,1144,3,waiting,11
2,10,937.8,515.5,335,-287,48,1,waiting,11
2,10,947.7,527.2,276,56,332,2,waiting,11
2,10,940.2,525.2,278,407,685,3,waiting,11
2,10,936.5,507.8,304,694,998,4,waiting,11
2,11,948.2,525.1,242,-67,175,1,waiting,11
2,11,942.6,507.3,637,187,824,2,waiting,11
2,11,957.4,516.3,538,833,1371,3,waiting,11
2,11,959.8,586.5,265,1396,1661,4,targOff,11
2,12,955.1,519.7,322,-284,38,1,waiting,11
2,12,940.2,523.1,569,46,615,2,waiting,11
2,12,939.7,543.8,272,760,1032,3,waiting,11
2,13,816.3,538,305,-283,22,1,waiting,11
2,13,951.4,544.9,399,117,516,2,waiting,11
2,13,907.3,512.6,194,541,735,3,waiting,11
2,13,946.6,534.4,338,748,1086,4,waiting,11
2,14,852.4,511.1,359,-288,71,1,waiting,11
2,14,949.2,519.8,164,94,258,2,waiting,11
2,14,990.6,531.3,233,753,986,3,waiting,11
2,14,776.3,516,162,1019,1181,4,waiting,11
2,15,769.4,-644.7,23,296,319,1,waiting,11
2,15,768,-642.6,44,396,440,2,waiting,11
2,15,393.5,-348.7,171,508,679,3,waiting,11
2,15,580.7,-355.6,48,840,888,4,waiting,11
2,16,1037.9,482.7,216,-185,31,1,waiting,11
2,16,938.4,530.8,1358,52,1410,2,waiting,11
2,16,1113.2,524.6,191,1440,1631,3,targOff,11
2,17,1292.4,-427,32,390,422,1,waiting,11
2,17,643.8,-352.3,75,804,879,2,waiting,11
2,17,627.1,-392.2,49,918,967,3,waiting,11
2,17,641.4,-403.8,190,1022,1212,4,waiting,11
2,18,463.9,-275.3,158,1073,1231,1,waiting,11
2,19,934.5,530.3,1991,-280,1711,1,waiting,11
2,20,945.2,542.8,291,-119,172,1,waiting,11
2,20,925.9,528.6,1516,182,1698,2,waiting,11
2,21,929.8,538.4,2000,-4,1996,1,waiting,11
2,21,927.8,509.1,70,2008,2078,2,targOff,11
2,22,828.7,524.2,190,-146,44,1,waiting,11
2,22,933.3,538.5,2027,70,2097,2,waiting,11
2,23,932.5,521.6,2102,-288,1814,1,waiting,11
2,24,929.7,527.9,1957,-277,1680,1,waiting,11
2,25,939.7,535.6,1649,-179,1470,1,waiting,11
2,25,1108,523.5,261,1499,1760,2,targOff,11
2,26,922.5,525.2,293,-273,20,1,waiting,11
2,26,937.5,530.6,1703,27,1730,2,waiting,11
2,26,744.4,526.7,298,1766,2064,3,targOff,11
2,27,820.7,518.1,156,-149,7,1,waiting,11
2,27,935.2,540.7,338,34,372,2,waiting,11
2,27,943.3,530.9,508,381,889,3,waiting,11
2,27,1138.8,527.8,106,925,1031,4,waiting,11
2,28,944.4,529.8,1225,-2,1223,1,waiting,11
2,28,780.5,534.2,599,1248,1847,2,dotOff,11
2,29,944.4,526,1852,-271,1581,1,waiting,11
2,30,945.2,531.6,1783,-285,1498,1,waiting,11
2,31,946.4,529.8,1735,8,1743,1,waiting,11
2,32,953,528.9,1769,-188,1581,1,waiting,11
2,33,959.7,518.9,1995,-281,1714,1,waiting,11
2,34,957.9,532.3,1549,-275,1274,1,waiting,11
2,34,1117.6,550.8,681,1300,1981,2,dotOff,11
2,35,956.5,540.3,448,-202,246,1,waiting,11
2,35,942.2,543.3,1094,254,1348,2,waiting,11
2,35,772,544.1,536,1378,1914,3,targVis,11
2,36,938.5,522,1792,-282,1510,1,waiting,11
2,36,1117.2,533.1,259,1539,1798,2,targOff,11
2,37,931.1,531.5,1659,-22,1637,1,waiting,11
2,37,755.8,531.3,274,1670,1944,2,targOff,11
2,38,810,535.1,318,-282,36,1,waiting,11
2,38,925,531.9,1056,58,1114,2,waiting,11
2,39,869.3,527.6,186,-180,6,1,waiting,11
2,39,927.2,529.9,1017,23,1040,2,waiting,11
2,39,1121.9,530.5,455,1076,1531,3,targOff,11
2,40,939.1,530.6,1646,-278,1368,1,waiting,11
2,40,1107,539.2,220,1394,1614,2,targOff,11
2,1,941.2,511.9,1456,39,1495,1,waiting,12
2,2,941.7,515,2123,-280,1843,1,waiting,12
2,3,943.8,534.2,222,-49,173,1,waiting,12
2,3,938.7,536.7,875,273,1148,2,waiting,12
2,4,933.9,524.8,1930,-285,1645,1,waiting,12
2,5,935.5,514.8,1780,-283,1497,1,waiting,12
2,6,943.5,519.1,2192,-278,1914,1,waiting,12
2,7,935.1,515.8,1564,-16,1548,1,waiting,12
2,8,940.2,519.8,985,146,1131,1,waiting,12
2,9,939.1,521.1,1876,-279,1597,1,waiting,12
2,10,932.8,511.6,2182,-284,1898,1,waiting,12
2,11,933.3,519.9,2141,-277,1864,1,waiting,12
2,12,935.9,515.5,1912,-231,1681,1,waiting,12
2,13,920.9,513.7,319,-283,36,1,waiting,12
2,13,932.1,519.8,1533,47,1580,2,waiting,12
2,14,917,537.2,328,-286,42,1,waiting,12
2,14,934.5,525.5,205,56,261,2,waiting,12
2,14,943.5,524.6,1356,270,1626,3,waiting,12
2,15,928.1,520.4,1850,-286,1564,1,waiting,12
2,16,935.4,514.2,2092,-279,1813,1,waiting,12
2,17,938.3,505.9,1806,-159,1647,1,waiting,12
2,18,935,511.9,1733,-3,1730,1,waiting,12
2,19,944.4,512.3,2113,-282,1831,1,waiting,12
2,20,935.7,512.7,2099,-285,1814,1,waiting,12
2,21,944.7,507.9,1912,-281,1631,1,waiting,12
2,22,939.7,512.1,1746,-17,1729,1,waiting,12
2,23,934.5,516.1,1973,-279,1694,1,waiting,12
2,24,943.2,530.4,561,-37,524,1,waiting,12
2,24,1103.1,520.7,285,550,835,2,waiting,12
2,24,1122.1,517.3,237,844,1081,3,waiting,12
2,25,929.6,513.7,1873,-165,1708,1,waiting,12
2,25,950,512.6,45,1716,1761,2,targOff,12
2,26,933.8,515.9,2018,-287,1731,1,waiting,12
2,27,938.3,526.1,2008,-279,1729,1,waiting,12
2,28,938.7,515.7,1487,10,1497,1,waiting,12
2,29,939.9,515.8,1824,-279,1545,1,waiting,12
2,30,940.4,517.2,1693,-30,1663,1,waiting,12
2,31,939.1,523.5,1785,-287,1498,1,waiting,12
2,32,936.9,530.1,1756,-25,1731,1,waiting,12
2,33,946.2,529.7,657,-282,375,1,waiting,12
2,33,947.4,518.8,1349,382,1731,2,waiting,12
2,34,939.5,520.2,1822,-41,1781,1,waiting,12
2,35,948.2,525.2,2111,-230,1881,1,waiting,12
2,36,948.8,532.3,1943,-278,1665,1,waiting,12
2,37,942.3,519.3,2042,-278,1764,1,waiting,12
2,38,944.7,513.2,1597,-280,1317,1,waiting,12
2,38,955.6,537.5,63,1391,1454,2,targOff,12
2,38,950.4,539.5,119,1557,1676,3,targOff,12
2,39,921.6,538.2,338,-275,63,1,waiting,12
2,39,940.8,520,1823,74,1897,2,waiting,12
2,40,946.2,522.5,395,5,400,1,waiting,12
2,40,930.4,517.3,1424,407,1831,2,waiting,12
2,1,919,486.3,302,-283,19,1,waiting,13
2,1,954.4,508.5,216,33,249,2,waiting,13
2,1,942.3,539.1,35,258,293,3,waiting,13
2,1,937.6,519.1,925,333,1258,4,waiting,13
2,1,772,514.3,528,1286,1814,5,targVis,13
2,2,939.6,520.2,1573,-286,1287,1,waiting,13
2,2,791.6,513.7,467,1313,1780,2,targOff,13
2,3,950.6,526.4,1080,-48,1032,1,waiting,13
2,3,1131,518,367,1064,1431,2,targOff,13
2,4,947.5,517.3,1809,-290,1519,1,waiting,13
2,4,1125.5,521.1,361,1550,1911,2,targOff,13
2,5,1088.5,510.9,329,-283,46,1,waiting,13
2,5,949.6,513.6,1095,72,1167,2,waiting,13
2,5,777,508.2,400,1197,1597,3,targOff,13
2,6,947,522.5,1661,-285,1376,1,waiting,13
2,6,1126.5,520.3,545,1402,1947,2,targVis,13
2,7,949.4,521.8,1411,-65,1346,1,waiting,13
2,7,1132.2,514.3,219,1378,1597,2,targOff,13
2,8,944.3,529.4,300,-61,239,1,waiting,13
2,8,942.3,521,1123,247,1370,2,waiting,13
2,8,1126.3,524.3,574,1406,1980,3,dotOff,13
2,9,949.6,521.1,1988,-58,1930,1,waiting,13
2,10,942.8,537.1,564,-13,551,1,waiting,13
2,10,934.5,528.3,1021,559,1580,2,waiting,13
2,11,949.2,603.6,269,-214,55,1,waiting,13
2,11,969.6,571.4,212,67,279,2,waiting,13
2,11,954.6,540.1,1494,287,1781,3,waiting,13
2,12,943.4,522.8,1626,-282,1344,1,waiting,13
2,12,1123.2,527.8,355,1376,1731,2,targOff,13
2,13,937.8,522,1404,-35,1369,1,waiting,13
2,13,749.7,531.8,543,1404,1947,2,targVis,13
2,14,922.4,538.3,280,-276,4,1,waiting,13
2,14,944.6,539.4,1547,17,1564,2,waiting,13
2,15,936.7,530.3,1494,-31,1463,1,waiting,13
2,15,1112.2,523.6,340,1490,1830,2,targOff,13
2,16,1025.7,524.1,187,-131,56,1,waiting,13
2,16,939.8,536.4,160,77,237,2,waiting,13
2,16,946.1,526.2,802,246,1048,3,waiting,13
2,16,788.9,523.1,591,1072,1663,4,dotOff,13
2,17,950.4,530.7,1468,-282,1186,1,waiting,13
2,17,1117.3,530.2,262,1220,1482,2,targOff,13
2,18,944.9,522.9,1576,-48,1528,1,waiting,13
2,18,1116,531.6,289,1559,1848,2,targOff,13
2,19,946.8,532.3,238,-31,207,1,waiting,13
2,19,943.7,522.6,1282,215,1497,2,waiting,13
2,19,1106.7,536.1,242,1523,1765,3,targOff,13
2,19,1126.5,527.4,72,1775,1847,4,targOff,13
2,20,942.2,529.7,1370,-85,1285,1,waiting,13
2,20,758.6,528.3,564,1312,1876,2,dotOff,13
2,21,713.7,535.3,284,-272,12,1,waiting,13
2,21,940.5,526,994,51,1045,2,waiting,13
2,21,742.1,534.9,601,1079,1680,3,dotOff,13
2,22,922.6,530.1,324,-280,44,1,waiting,13
2,22,937.9,521.8,1372,52,1424,2,waiting,13
2,22,749,519.2,240,1457,1697,3,targOff,13
2,23,940.4,527.2,1539,-140,1399,1,waiting,13
2,23,1123.6,521.6,315,1432,1747,2,targOff,13
2,24,982.3,561.2,157,-109,48,1,waiting,13
2,24,940.5,533.2,1235,61,1296,2,waiting,13
2,24,771.9,544.4,509,1321,1830,3,targOff,13
2,25,951.4,514.1,291,-280,11,1,waiting,13
2,25,934.9,528.8,1352,20,1372,2,waiting,13
2,25,1116.3,535.9,538,1410,1948,3,targVis,13
2,26,938,530.1,529,-14,515,1,waiting,13
2,26,932.5,528.3,1011,524,1535,2,waiting,13
2,26,746.6,521.4,359,1571,1930,3,targOff,13
2,27,936.1,538.2,1966,-232,1734,1,waiting,13
2,27,754.2,522.4,210,1770,1980,2,targOff,13
2,28,939.3,529.7,1040,7,1047,1,waiting,13
2,28,1119.6,523.4,554,1076,1630,2,targVis,13
2,29,941.9,528.7,1266,-38,1228,1,waiting,13
2,29,1109.6,524.2,373,1258,1631,2,targOff,13
2,30,941.8,533.4,1679,-278,1401,1,waiting,13
2,30,1101.8,537.9,568,1425,1993,2,dotOff,13
2,31,937.8,538.4,1253,-14,1239,1,waiting,13
2,31,767.9,527.6,278,1269,1547,2,targOff,13
2,32,941.5,529.4,1687,-25,1662,1,waiting,13
2,32,1123.9,542.8,297,1700,1997,2,targOff,13
2,33,942.3,536.7,1271,-17,1254,1,waiting,13
2,33,755.5,531.5,357,1288,1645,2,targOff,13
2,34,953.6,549,138,-1,137,1,waiting,13
2,34,944.5,531.3,357,226,583,2,waiting,13
2,34,1168.9,534.9,112,623,735,3,waiting,13
2,34,1117.1,527.3,33,748,781,4,waiting,13
2,35,946.2,533.5,1669,-112,1557,1,waiting,13
2,35,761.6,529,230,1584,1814,2,targOff,13
2,36,942.5,529.4,1614,-36,1578,1,waiting,13
2,36,1124.4,529.8,241,1606,1847,2,targOff,13
2,37,942.5,529.9,1645,-270,1375,1,waiting,13
2,37,784.9,526.1,556,1409,1965,2,targVis,13
2,38,941.9,532.2,942,-278,664,1,waiting,13
2,38,1101.5,532.4,190,690,880,2,waiting,13
2,39,903.5,535.7,292,-288,4,1,waiting,13
2,39,929.9,536,1455,18,1473,2,waiting,13
2,39,1113.5,538,526,1505,2031,3,targVis,13
2,40,942.1,523.5,1997,-290,1707,1,waiting,13
2,1,1224.7,496.9,418,-248,170,1,waiting,14
2,1,1085.2,531.7,269,195,464,2,waiting,14
2,1,962.2,523.9,692,486,1178,3,waiting,14
2,2,954.9,518.3,2000,-136,1864,1,waiting,14
2,3,958,517.1,1998,-284,1714,1,waiting,14
2,4,952.5,516.9,2059,-281,1778,1,waiting,14
2,4,783.7,504.1,191,1806,1997,2,targOff,14
2,5,926.8,505.2,332,-278,54,1,waiting,14
2,5,951.9,526.9,1498,66,1564,2,waiting,14
2,6,850.5,520.1,137,-125,12,1,waiting,14
2,6,957.2,520.3,300,35,335,2,waiting,14
2,6,976.8,-4.5,367,413,780,3,waiting,14
2,6,911.8,562.1,135,845,980,4,waiting,14
2,6,976.5,523.7,213,1001,1214,5,waiting,14
2,7,910.5,538.2,224,-205,19,1,waiting,14
2,7,951.2,532.6,1584,30,1614,2,waiting,14
2,8,956.9,528.8,1960,-279,1681,1,waiting,14
2,9,949.8,516.8,2068,-271,1797,1,waiting,14
2,10,949.2,529.1,1806,-8,1798,1,waiting,14
2,11,947.5,521.5,1794,4,1798,1,waiting,14
2,12,942,527.8,2032,-34,1998,1,waiting,14
2,13,939,525.2,1860,-29,1831,1,waiting,14
2,14,938.4,521.4,1834,-53,1781,1,waiting,14
2,15,882.4,483.2,178,-173,5,1,waiting,14
2,15,943.4,530,1768,30,1798,2,waiting,14
2,16,951.6,530.3,1958,-27,1931,1,waiting,14
2,17,941.9,533.6,1502,-23,1479,1,waiting,14
2,17,779.8,528.4,257,1508,1765,2,targOff,14
2,17,939.9,524.4,88,1792,1880,3,targOff,14
2,18,943.2,529.6,2216,-201,2015,1,waiting,14
2,19,941.9,544.7,714,-278,436,1,waiting,14
2,20,947,530.9,1977,-279,1698,1,waiting,14
2,21,950.8,525.6,2218,-288,1930,1,waiting,14
2,22,945.4,525.7,1952,-288,1664,1,waiting,14
2,23,940.9,524.5,2007,-46,1961,1,waiting,14
2,24,940.1,544.7,127,-60,67,1,waiting,14
2,24,946.9,520,783,146,929,2,waiting,14
2,25,936.3,530,898,4,902,1,waiting,14
2,25,949.6,543.1,189,909,1098,2,waiting,14
2,25,944.4,530.9,858,1106,1964,3,waiting,14
2,26,944.7,528.6,2066,-285,1781,1,waiting,14
2,27,946,533.2,1899,-285,1614,1,waiting,14
2,28,950.5,516.8,283,-272,11,1,waiting,14
2,28,940.6,533.1,678,17,695,2,waiting,14
2,28,947.3,528,1295,702,1997,3,waiting,14
2,29,956,523.2,1983,-285,1698,1,waiting,14
2,30,940.4,524.9,1851,-171,1680,1,waiting,14
2,31,953.4,553.2,1659,-28,1631,1,waiting,14
2,32,922.4,547.4,504,-281,223,1,waiting,14
2,32,951.9,545.8,1379,234,1613,2,waiting,14
2,33,945.3,551.6,1614,-17,1597,1,waiting,14
2,34,940,542.6,1856,-275,1581,1,waiting,14
2,35,939,536.7,1899,-285,1614,1,waiting,14
2,36,950.5,547.5,1685,-54,1631,1,waiting,14
2,37,946.2,540.7,362,-283,79,1,waiting,14
2,37,943.5,536.3,1506,88,1594,2,waiting,14
2,38,933.8,536.3,1845,-38,1807,1,waiting,14
2,39,945.1,532.4,2072,-274,1798,1,waiting,14
2,40,939.2,529,1570,-40,1530,1,waiting,14
2,1,1287,618.6,164,-145,19,1,waiting,15
2,1,941.1,533.4,1171,60,1231,2,waiting,15
2,2,980.4,534.2,157,-115,42,1,waiting,15
2,2,931.7,540.3,211,53,264,2,waiting,15
2,2,764,528,275,289,564,3,waiting,15
2,2,951.1,539.3,159,603,762,4,waiting,15
2,2,932.7,530.5,224,770,994,5,waiting,15
2,2,745.5,518.2,37,1027,1064,6,waiting,15
2,3,940.2,533.6,1563,-285,1278,1,waiting,15
2,3,1108.9,524.8,528,1303,1831,2,targVis,15
2,4,980.9,532,167,-165,2,1,waiting,15
2,4,935.4,533.4,1384,13,1397,2,waiting,15
2,4,767.9,525.4,568,1429,1997,3,dotOff,15
2,5,944.8,533.1,1514,-280,1234,1,waiting,15
2,5,757.8,523.3,257,1269,1526,2,targOff,15
2,6,936.2,535.9,1509,-13,1496,1,waiting,15
2,6,1124.7,530.1,242,1522,1764,2,targOff,15
2,7,951.1,540.1,1721,-278,1443,1,waiting,15
2,7,1112.9,536.9,295,1469,1764,2,targOff,15
2,8,894.8,526.4,311,-282,29,1,waiting,15
2,8,935.7,526.9,1483,43,1526,2,waiting,15
2,8,1127.9,523.3,272,1555,1827,3,targOff,15
2,9,938.8,529.8,1601,-166,1435,1,waiting,15
2,9,749.7,524.9,328,1470,1798,2,targOff,15
2,10,943.8,527.5,1313,4,1317,1,waiting,15
2,10,763.2,524.2,382,1348,1730,2,targOff,15
2,11,953.2,524.4,296,-282,14,1,waiting,15
2,11,942.4,528.1,1125,21,1146,2,waiting,15
2,11,1113.4,530.3,352,1179,1531,3,dotOff,15
2,11,910.3,533.8,228,1567,1795,4,targOff,15
2,11,953.5,526.2,53,1809,1862,5,targOff,15
2,12,966.2,543.3,307,-287,20,1,waiting,15
2,12,938.5,535.4,1454,30,1484,2,waiting,15
2,12,1121.7,533.1,383,1515,1898,3,targOff,15
2,13,937.7,524.8,1644,-167,1477,1,waiting,15
2,13,763.4,521.4,305,1509,1814,2,targOff,15
2,14,940.7,527.7,1204,-123,1081,1,waiting,15
2,14,1104.4,533.4,719,1111,1830,2,dotOff,15
2,15,936,533,1577,-169,1408,1,waiting,15
2,15,1123.7,536.5,358,1440,1798,2,targOff,15
2,16,937.1,534.9,1395,20,1415,1,waiting,15
2,16,1111.8,533,488,1443,1931,2,targOff,15
2,17,1126.7,516.8,324,-280,44,1,waiting,15
2,17,924.8,542.1,707,78,785,2,waiting,15
2,17,751.1,526.6,278,819,1097,3,waiting,15
2,18,932.5,538.3,1124,1,1125,1,waiting,15
2,18,753,533.1,773,1158,1931,2,dotOff,15
2,19,912.1,529.9,233,-211,22,1,waiting,15
2,19,930.1,537.1,1047,32,1079,2,waiting,15
2,19,1126.7,527.8,781,1116,1897,3,dotOff,15
2,20,928.5,528.4,289,-279,10,1,waiting,15
2,20,923.3,534.4,1159,19,1178,2,waiting,15
2,20,929.1,520.7,314,1187,1501,3,dotOff,15
2,20,1108.7,530.5,570,1527,2097,4,dotOff,15
2,21,933.7,526.2,1679,-73,1606,1,waiting,15
2,21,765.4,533.9,296,1635,1931,2,targOff,15
2,22,936.3,530.7,1379,-278,1101,1,waiting,15
2,22,1126.5,529.4,526,1136,1662,2,dotOff,15
2,22,1116.9,512.2,158,1673,1831,3,targOff,15
2,23,928.5,530.9,1576,-278,1298,1,waiting,15
2,23,1113.2,535.2,805,1326,2131,2,dotOff,15
2,24,1067,573.3,291,-285,6,1,waiting,15
2,24,944.2,533.8,1669,30,1699,2,waiting,15
2,24,764.2,518.3,212,1735,1947,3,targOff,15
2,25,944,531.6,1387,-58,1329,1,waiting,15
2,25,1130.9,543.5,780,1367,2147,2,dotOff,15
2,26,930.6,534.5,312,-39,273,1,waiting,15
2,26,930.7,531.1,992,280,1272,2,waiting,15
2,26,767.1,526.1,452,1306,1758,3,dotOff,15
2,26,747.3,522,180,1767,1947,4,targOff,15
2,27,909.6,525.8,187,-175,12,1,waiting,15
2,27,925.1,526.3,527,22,549,2,waiting,15
2,27,921.3,535,893,557,1450,3,waiting,15
2,27,1086.9,533,383,1477,1860,4,dotOff,15
2,27,1114.1,532.9,360,1871,2231,5,targOff,15
2,28,917.4,518.2,203,-172,31,1,waiting,15
2,28,935.3,535.4,1223,42,1265,2,waiting,15
2,28,1105.1,530.1,539,1292,1831,3,targVis,15
2,29,932.5,530.5,1700,-32,1668,1,waiting,15
2,29,740.3,528.9,396,1701,2097,2,targOff,15
2,30,1024.9,530.2,264,-261,3,1,waiting,15
2,30,924.7,535.3,814,23,837,2,waiting,15
2,30,927.6,537.8,875,844,1719,3,waiting,15
2,30,762.2,538.1,398,1749,2147,4,targOff,15
2,31,921,546.2,97,-64,33,1,waiting,15
2,31,935.2,532.7,1377,97,1474,2,waiting,15
2,31,757.8,525.1,308,1506,1814,3,targOff,15
2,32,1130.7,527.8,303,-270,33,1,waiting,15
2,32,932.1,524.9,1226,68,1294,2,waiting,15
2,32,1119.4,529.8,778,1320,2098,3,dotOff,15
2,33,935,541.1,1053,45,1098,1,waiting,15
2,33,953.3,530,56,1108,1164,2,waiting,15
2,34,892.1,529.6,291,-283,8,1,waiting,15
2,34,934.2,538.3,1540,23,1563,2,waiting,15
2,34,756.9,527.8,365,1595,1960,3,targOff,15
2,35,907.1,544.7,165,-85,80,1,waiting,15
2,35,942.7,526.8,1294,97,1391,2,waiting,15
2,35,1128,529,705,1425,2130,3,dotOff,15
2,36,942.1,527.6,1559,-98,1461,1,waiting,15
2,36,773.9,522.6,319,1495,1814,2,targOff,15
2,37,962,542.9,192,-165,27,1,waiting,15
2,37,932,534.3,1395,36,1431,2,waiting,15
2,37,753.1,531.7,619,1462,2081,3,dotOff,15
2,38,939.2,529.6,1702,-283,1419,1,waiting,15
2,38,1110.3,534.1,457,1446,1903,2,dotOff,15
2,38,1124.2,530.6,214,1913,2127,3,targOff,15
2,39,932.4,525.7,1566,-285,1281,1,waiting,15
2,39,752.5,526.3,698,1316,2014,2,dotOff,15
2,40,907.4,557.5,310,-241,69,1,waiting,15
2,40,934.2,537.1,403,145,548,2,waiting,15
2,40,555.7,1225.6,21,602,623,3,waiting,15
2,40,940.7,529.1,265,683,948,4,waiting,15
2,1,1121.4,512,373,-283,90,1,waiting,16
2,1,961.6,542.2,772,119,891,2,waiting,16
2,1,782.3,526.8,875,922,1797,3,dotOff,16
2,2,948.3,528.8,1784,-283,1501,1,waiting,16
2,2,1117.5,530.5,336,1528,1864,2,targOff,16
2,3,939.4,521.1,2059,-149,1910,1,waiting,16
2,3,787.2,510.1,176,1938,2114,2,targOff,16
2,4,944.4,523.3,2023,-275,1748,1,waiting,16
2,5,948.9,533.5,1947,-283,1664,1,waiting,16
2,6,943.5,535.7,2089,-44,2045,1,waiting,16
2,7,941.4,526.5,2205,-295,1910,1,waiting,16
2,8,955.2,551.9,158,-133,25,1,waiting,16
2,8,932.6,531,230,39,269,2,waiting,16
2,8,939.2,521.8,1836,278,2114,3,waiting,16
2,9,939.9,522.9,1792,-129,1663,1,waiting,16
2,10,930.9,515.8,1316,-27,1289,1,waiting,16
2,10,931.4,528.1,681,1299,1980,2,dotOff,16
2,11,936.7,527.7,2140,-297,1843,1,waiting,16
2,12,932.3,535.8,1793,-50,1743,1,waiting,16
2,12,923.7,524.3,130,1750,1880,2,targOff,16
2,13,934.7,537.1,1765,-34,1731,1,waiting,16
2,14,940.8,555.9,1690,-45,1645,1,waiting,16
2,14,950.3,554.1,94,1653,1747,2,targOff,16
2,15,935.1,541.2,1253,-279,974,1,waiting,16
2,15,944.3,531.5,413,1044,1457,2,dotOff,16
2,15,945,549.9,219,1546,1765,3,targOff,16
2,16,1097.8,600.1,252,-251,1,1,waiting,16
2,16,910.6,583.6,203,34,237,2,waiting,16
2,16,934.8,536.2,1509,260,1769,3,waiting,16
2,16,972.5,572.6,181,1783,1964,4,targOff,16
2,17,954.2,521.4,2343,-278,2065,1,waiting,16
2,18,955.2,517.2,114,-65,49,1,waiting,16
2,18,954.9,520.4,1048,163,1211,2,waiting,16
2,19,944.9,543.4,462,-280,182,1,waiting,16
2,19,944.9,542.9,1640,189,1829,2,waiting,16
2,19,947.7,531.3,203,1840,2043,3,targOff,16
2,20,940.2,527.3,2420,-272,2148,1,waiting,16
2,21,951.6,539.1,923,-279,644,1,waiting,16
2,21,953.3,547.3,108,752,860,2,waiting,16
2,22,959.4,539.9,2012,-30,1982,1,waiting,16
2,23,940,533,2294,-280,2014,1,waiting,16
2,24,940.2,527.2,2026,-78,1948,1,waiting,16
2,25,935.9,530.5,1871,-23,1848,1,waiting,16
2,26,912.7,546.1,281,-281,0,1,waiting,16
2,26,941,535.7,2072,9,2081,2,waiting,16
2,27,943.4,533,1899,-35,1864,1,waiting,16
2,28,936.2,526,2051,-20,2031,1,waiting,16
2,29,939.7,526.8,2233,-136,2097,1,waiting,16
2,30,940.7,536.2,2173,-25,2148,1,waiting,16
2,31,938.7,534.2,1745,-31,1714,1,waiting,16
2,32,941.6,523.4,1878,-33,1845,1,waiting,16
2,33,939.9,523,2103,-39,2064,1,waiting,16
2,34,939.4,526,1977,-284,1693,1,waiting,16
2,35,936,532,1871,-24,1847,1,waiting,16
2,36,941.9,532.9,2023,-297,1726,1,waiting,16
2,37,934.8,542.7,2043,-281,1762,1,waiting,16
2,38,932,528.9,2311,-280,2031,1,waiting,16
2,39,933.5,522.5,2149,-1,2148,1,waiting,16
2,40,937.4,519.1,2059,-281,1778,1,waiting,16
2,1,1091.1,551.3,513,-281,232,1,waiting,17
2,1,827.7,540.2,249,271,520,2,waiting,17
2,1,932.3,540.7,374,539,913,3,waiting,17
2,2,930.9,540.7,1329,-294,1035,1,waiting,17
2,2,788.5,539.7,818,1060,1878,2,dotOff,17
2,3,934.1,528.4,1326,-23,1303,1,waiting,17
2,3,753.5,530.1,230,1334,1564,2,targOff,17
2,4,929.1,526.7,1530,15,1545,1,waiting,17
2,4,763.1,522,137,1577,1714,2,targOff,17
2,5,931.2,527.5,1470,-281,1189,1,waiting,17
2,5,1087.8,525.8,527,1216,1743,2,targVis,17
2,6,903.6,518.9,301,-281,20,1,waiting,17
2,6,933,534.8,1200,33,1233,2,waiting,17
2,6,755.4,531.8,434,1264,1698,3,targOff,17
2,7,931.4,527.5,1551,-285,1266,1,waiting,17
2,7,753.6,523.9,348,1299,1647,2,targOff,17
2,8,933.4,537.2,574,-9,565,1,waiting,17
2,8,1115.2,535.1,405,588,993,2,waiting,17
2,9,930.6,531.6,1475,-286,1189,1,waiting,17
2,9,1103.2,528.9,314,1217,1531,2,targOff,17
2,10,936.5,532.2,1144,-34,1110,1,waiting,17
2,10,761.2,540.9,539,1142,1681,2,targVis,17
2,11,971.6,530.2,191,-178,13,1,waiting,17
2,11,935.5,538.9,1355,21,1376,2,waiting,17
2,11,743.5,545.3,538,1409,1947,3,targVis,17
2,12,932.9,542.6,1442,-281,1161,1,waiting,17
2,12,760,542.1,304,1193,1497,2,targOff,17
2,13,941.4,534.8,1556,-2,1554,1,waiting,17
2,13,776.1,534.4,464,1579,2043,2,targOff,17
2,14,941.2,537,1323,-288,1035,1,waiting,17
2,14,1119,529.7,677,1071,1748,2,dotOff,17
2,15,931.8,551.7,267,-28,239,1,waiting,17
2,15,937.9,541.2,1093,248,1341,2,waiting,17
2,15,782.2,539.7,665,1366,2031,3,dotOff,17
2,16,938.6,547.8,1539,-219,1320,1,waiting,17
2,16,781.8,537.4,419,1349,1768,2,dotOff,17
2,16,748.2,540.2,170,1777,1947,3,targOff,17
2,17,898.8,542.9,309,-287,22,1,waiting,17
2,17,933,537.1,1209,35,1244,2,waiting,17
2,17,1113.7,525.7,291,1273,1564,3,targOff,17
2,18,935.4,527.6,1673,-7,1666,1,waiting,17
2,18,752.9,542.9,286,1695,1981,2,targOff,17
2,19,739.1,534.3,428,-288,140,1,waiting,17
2,19,946.3,544.5,135,181,316,2,waiting,17
2,19,914.6,541.2,472,326,798,3,waiting,17
2,20,937.8,551.8,507,2,509,1,waiting,17
2,20,766.9,538.3,422,540,962,2,waiting,17
2,21,1021.2,520.8,178,-132,46,1,waiting,17
2,21,933,542.5,311,65,376,2,waiting,17
2,21,940.9,536.4,942,388,1330,3,waiting,17
2,21,753.7,535.1,698,1366,2064,4,dotOff,17
2,22,942,536.7,1313,-242,1071,1,waiting,17
2,22,1126.9,527,622,1107,1729,2,dotOff,17
2,23,941.6,538.2,1515,-281,1234,1,waiting,17
2,23,735.3,541.7,227,1269,1496,2,targOff,17
2,23,756.7,536.8,186,1507,1693,3,targOff,17
2,24,937,536.8,740,-22,718,1,waiting,17
2,24,773.8,528.7,138,743,881,2,waiting,17
2,25,879.5,513.6,298,-275,23,1,waiting,17
2,25,936.9,555.3,443,42,485,2,waiting,17
2,25,1481.2,-421.7,61,533,594,3,waiting,17
2,25,1453.1,-433.3,223,607,830,4,waiting,17
2,25,1468.3,-433.8,27,852,879,5,waiting,17
2,25,935.1,540.4,81,1149,1230,6,waiting,17
2,26,935.5,531.4,1649,-286,1363,1,waiting,17
2,26,775.7,531.9,429,1395,1824,2,dotOff,17
2,26,759.7,523.8,165,1832,1997,3,targOff,17
2,27,932.6,537.8,1544,-195,1349,1,waiting,17
2,27,1104.3,532.5,607,1374,1981,2,dotOff,17
2,28,925.6,539.3,1577,-283,1294,1,waiting,17
2,28,769.4,534.7,628,1320,1948,2,dotOff,17
2,29,935.6,532.9,718,3,721,1,waiting,17
2,29,947.3,532.5,766,729,1495,2,waiting,17
2,29,1134.4,534.4,382,1529,1911,3,targOff,17
2,30,943.7,549.6,515,-282,233,1,waiting,17
2,30,949.5,538.2,1319,241,1560,2,waiting,17
2,30,1128.3,530.8,354,1594,1948,3,targOff,17
2,31,939,530.7,1517,-66,1451,1,waiting,17
2,31,779.7,542.1,540,1474,2014,2,targVis,17
2,32,933.9,543.2,1562,-289,1273,1,waiting,17
2,32,1121.2,548.4,523,1307,1830,2,targVis,17
2,33,945.4,538.1,1565,-287,1278,1,waiting,17
2,33,1125.6,534,593,1304,1897,2,dotOff,17
2,34,938.9,525.9,1374,-29,1345,1,waiting,17
2,34,763.1,532.5,521,1371,1892,2,targVis,17
2,35,940.5,528,1580,-295,1285,1,waiting,17
2,35,758.6,533.1,551,1311,1862,2,targVis,17
2,36,905.5,543.3,311,-278,33,1,waiting,17
2,36,935.5,536.1,1098,45,1143,2,waiting,17
2,36,1124,537.3,475,1169,1644,3,targOff,17
2,37,906.9,530.5,295,-283,12,1,waiting,17
2,37,937.1,538.6,1267,26,1293,2,waiting,17
2,37,1108.6,538.1,323,1325,1648,3,targOff,17
2,38,934.9,537.9,1668,2,1670,1,waiting,17
2,38,735.4,528,290,1703,1993,2,targOff,17
2,39,937.4,535.3,966,-33,933,1,waiting,17
2,39,1096.2,529.5,570,957,1527,2,dotOff,17
2,40,1117.4,528.4,526,-284,242,1,waiting,17
2,40,843.3,530.5,269,281,550,2,waiting,17
2,40,900.6,531.1,187,564,751,3,waiting,17
2,40,935.2,526.3,133,764,897,4,waiting,17
2,1,979,474.7,342,43,385,1,waiting,18
2,1,1134,497.7,149,409,558,2,waiting,18
2,1,964.8,517,657,586,1243,3,waiting,18
2,2,989.6,518.9,305,-283,22,1,waiting,18
2,2,965.7,529.5,1783,31,1814,2,waiting,18
2,3,956.1,525,2170,-272,1898,1,waiting,18
2,4,967.8,530,1872,-125,1747,1,waiting,18
2,5,953.5,527.5,337,-286,51,1,waiting,18
2,5,954.5,517,822,142,964,2,waiting,18
2,6,941.2,524.4,2087,-289,1798,1,waiting,18
2,7,943.9,521.7,1931,-34,1897,1,waiting,18
2,8,940.7,529.3,1966,-101,1865,1,waiting,18
2,9,939,531.5,1802,-4,1798,1,waiting,18
2,10,941.6,530.9,1933,-285,1648,1,waiting,18
2,11,939.9,532.8,2133,-269,1864,1,waiting,18
2,12,938.7,531.7,1261,-43,1218,1,waiting,18
2,12,943.6,527.2,738,1226,1964,2,dotOff,18
2,13,940.8,524,1871,-223,1648,1,waiting,18
2,14,938.3,527.8,2148,-284,1864,1,waiting,18
2,15,927.9,527.9,1250,-32,1218,1,waiting,18
2,15,886,543.6,51,1404,1455,2,targVis,18
2,15,788.2,-415,139,1497,1636,3,targOff,18
2,16,932.6,532.4,1900,-236,1664,1,waiting,18
2,17,952.8,536.2,2084,-287,1797,1,waiting,18
2,18,956.3,541.8,1948,-283,1665,1,waiting,18
2,19,944.5,554.8,1986,-22,1964,1,waiting,18
2,20,938.6,527.2,1743,-45,1698,1,waiting,18
2,21,930.3,525.5,1917,-45,1872,1,waiting,18
2,22,924.9,540.3,1873,-65,1808,1,waiting,18
2,22,934.8,535.8,129,1818,1947,2,targOff,18
2,23,939.6,523,1757,-10,1747,1,waiting,18
2,24,931.7,533.1,2000,-287,1713,1,waiting,18
2,25,943.7,526.3,1566,-19,1547,1,waiting,18
2,26,937.3,525.3,1698,-34,1664,1,waiting,18
2,27,941.2,538,1567,-54,1513,1,waiting,18
2,28,929.7,539.7,2113,-282,1831,1,waiting,18
2,29,931.1,549.5,363,-280,83,1,waiting,18
2,29,935,527.9,1472,92,1564,2,waiting,18
2,30,921.7,526.1,2051,-287,1764,1,waiting,18
2,31,927.3,526,1616,14,1630,1,waiting,18
2,32,926.6,526.6,1623,-41,1582,1,waiting,18
2,33,930.2,537.5,334,-8,326,1,waiting,18
2,33,934.2,525.8,1496,335,1831,2,waiting,18
2,34,931.1,536.2,599,-9,590,1,waiting,18
2,34,946.7,534.8,1374,607,1981,2,waiting,18
2,35,913.6,531.4,329,-278,51,1,waiting,18
2,35,937,528,1599,61,1660,2,waiting,18
2,35,917.2,522.9,112,1669,1781,3,targOff,18
2,36,927.9,523.8,1632,-18,1614,1,waiting,18
2,37,865.5,540.5,196,-181,15,1,waiting,18
2,37,934.7,526.6,1647,34,1681,2,waiting,18
2,38,928.8,535.9,1586,-55,1531,1,waiting,18
2,39,922.6,527.3,1267,-288,979,1,waiting,18
2,39,941.4,533.6,728,986,1714,2,dotOff,18
2,40,921.3,535.2,566,-279,287,1,waiting,18
2,40,931.1,536.5,1519,295,1814,2,waiting,18
2,1,1171.5,547.5,246,-136,110,1,waiting,19
2,1,916.2,555.6,180,147,327,2,waiting,19
2,1,942.7,528.5,802,344,1146,3,waiting,19
2,2,942.3,519.5,610,-281,329,1,waiting,19
2,2,911.2,520.3,138,339,477,2,waiting,19
2,2,940.2,520.1,835,488,1323,3,waiting,19
2,2,778,527.3,558,1356,1914,4,targVis,19
2,3,935.3,519.4,1828,-282,1546,1,waiting,19
2,3,760.5,514.8,52,1580,1632,2,targOff,19
2,4,978,534,288,-282,6,1,waiting,19
2,4,927.5,522.9,1142,19,1161,2,waiting,19
2,4,755.4,527.9,478,1186,1664,3,targOff,19
2,5,945.7,519.4,1245,-16,1229,1,waiting,19
2,5,1114.1,524.8,476,1255,1731,2,targOff,19
2,6,939.9,531,1575,-285,1290,1,waiting,19
2,6,771.1,527.2,430,1318,1748,2,targOff,19
2,7,936.9,521,1622,-279,1343,1,waiting,19
2,7,752.4,528,476,1371,1847,2,targOff,19
2,8,920.9,519,1574,-285,1289,1,waiting,19
2,8,715,522.4,204,1323,1527,2,targOff,19
2,8,745.6,519.7,129,1536,1665,3,targOff,19
2,9,810.8,556.9,334,-279,55,1,waiting,19
2,9,928,548.3,245,80,325,2,waiting,19
2,9,735.5,528.2,196,364,560,3,waiting,19
2,9,750.1,520.1,383,614,997,4,waiting,19
2,10,1112.5,500.7,284,-276,8,1,waiting,19
2,10,923.2,522.4,497,44,541,2,waiting,19
2,10,748.2,515,397,573,970,3,waiting,19
2,10,907,526.5,253,995,1248,4,waiting,19
2,11,875.9,515.7,240,-226,14,1,waiting,19
2,11,924,530.6,1616,34,1650,2,waiting,19
2,11,770.2,523.7,52,1678,1730,3,targOff,19
2,12,944.4,520.4,1395,2,1397,1,waiting,19
2,12,743.3,524.8,344,1429,1773,2,targOff,19
2,12,765.7,516.7,48,1782,1830,3,targOff,19
2,13,882.3,532.3,293,-282,11,1,waiting,19
2,13,939.3,541.2,214,28,242,2,waiting,19
2,13,944.3,529.1,846,252,1098,3,waiting,19
2,13,764.6,532,480,1134,1614,4,targOff,19
2,14,938.4,528.4,1941,6,1947,1,waiting,19
2,15,970.3,528,339,-286,53,1,waiting,19
2,15,937,534.7,796,301,1097,2,waiting,19
2,16,928.5,525.3,1362,-277,1085,1,waiting,19
2,16,765.1,527.8,64,1116,1180,2,waiting,19
2,17,905.1,544.9,207,-114,93,1,waiting,19
2,17,916.6,542.6,569,105,674,2,waiting,19
2,17,931.2,535.9,148,683,831,3,waiting,19
2,18,910.9,515.8,329,-272,57,1,waiting,19
2,18,939.8,527.8,1460,70,1530,2,waiting,19
2,20,956.3,535.3,403,15,418,1,waiting,19
2,20,955.4,533,936,426,1362,2,waiting,19
2,20,1150.9,537.6,165,1400,1565,3,targOff,19
2,21,955.6,513.1,576,-285,291,1,waiting,19
2,21,961,525.6,733,365,1098,2,waiting,19
2,22,989.2,501,344,-273,71,1,waiting,19
2,22,947.9,520.2,1289,80,1369,2,waiting,19
2,22,782.8,512.1,447,1400,1847,3,targOff,19
2,23,956.6,520.2,1317,-1,1316,1,waiting,19
2,23,1123.6,538.7,530,1351,1881,2,targVis,19
2,24,952.8,509.7,1462,-280,1182,1,waiting,19
2,24,783.3,508.9,536,1212,1748,2,targVis,19
2,25,954.1,519.9,1698,-282,1416,1,waiting,19
2,25,1143.1,521.5,351,1446,1797,2,targOff,19
2,26,992.3,513.3,160,-142,18,1,waiting,19
2,26,944.7,512.8,1212,31,1243,2,waiting,19
2,26,764.4,511.1,339,1275,1614,3,targOff,19
2,27,943.3,519.2,222,-8,214,1,waiting,19
2,27,935.7,516.3,822,221,1043,2,waiting,19
2,27,756.7,514.4,504,1076,1580,3,targOff,19
2,28,948.9,521.2,1139,-58,1081,1,waiting,19
2,28,1118.9,527,507,1107,1614,2,targOff,19
2,29,948.3,522.5,1514,-279,1235,1,waiting,19
2,29,1118.2,521.9,517,1264,1781,2,targVis,19
2,30,1094.7,505.8,298,-284,14,1,waiting,19
2,30,940.3,532.2,1793,38,1831,2,waiting,19
2,31,918.6,528.5,237,-232,5,1,waiting,19
2,31,937.2,532.7,1897,13,1910,2,waiting,19
2,32,844.3,510.5,310,-284,26,1,waiting,19
2,32,942.7,523.9,1353,49,1402,2,waiting,19
2,32,766.2,517.8,201,1429,1630,3,targOff,19
2,33,942.7,526.7,1320,-39,1281,1,waiting,19
2,33,1121.8,526.5,281,1316,1597,2,targOff,19
2,34,945.6,518.4,1313,-215,1098,1,waiting,19
2,34,1103.2,534.9,401,1123,1524,2,dotOff,19
2,34,914.7,528.7,162,1552,1714,3,targOff,19
2,35,928.2,515.7,285,-28,257,1,waiting,19
2,35,941.8,513.8,709,264,973,2,waiting,19
2,35,1109.8,517.8,493,1004,1497,3,targOff,19
2,36,934.5,519.9,1140,-9,1131,1,waiting,19
2,36,768.7,529.2,765,1161,1926,2,waiting,19
2,37,943.1,539.5,1295,-222,1073,1,waiting,19
2,37,1114.4,535.9,843,1104,1947,2,waiting,19
2,38,946.1,543.7,2118,-288,1830,1,waiting,19
2,39,936.4,536.5,1433,-281,1152,1,waiting,19
2,39,769.7,539.5,532,1181,1713,2,targVis,19
2,40,940.9,533.2,1416,-128,1288,1,waiting,19
2,40,770.6,537.4,514,1317,1831,2,targVis,19
2,1,1015.1,522.4,204,-196,8,1,waiting,20
2,1,948.3,527.4,1660,20,1680,2,waiting,20
2,2,942.1,529.3,319,-44,275,1,waiting,20
2,2,1112.7,526.3,339,305,644,2,waiting,20
2,2,941.5,524.4,226,671,897,3,waiting,20
2,3,941.5,574.9,221,10,231,1,waiting,20
2,3,934.6,624.6,179,267,446,2,waiting,20
2,3,937.5,568.9,154,794,948,3,waiting,20
2,4,947.5,524.2,1910,-279,1631,1,waiting,20
2,5,940.8,520.5,1797,-283,1514,1,waiting,20
2,6,941.3,539.9,2015,-284,1731,1,waiting,20
2,7,948.4,547.5,2215,-284,1931,1,waiting,20
2,8,958.3,544.4,1685,-75,1610,1,waiting,20
2,9,954.3,529.8,522,-241,281,1,waiting,20
2,9,955.2,538.7,1408,289,1697,2,waiting,20
2,10,961.2,556.1,287,-12,275,1,waiting,20
2,10,960.7,544.6,568,294,862,2,waiting,20
2,10,958.4,540,547,1034,1581,3,targVis,20
2,11,984,590.8,128,-72,56,1,waiting,20
2,11,962.4,559.4,1783,64,1847,2,waiting,20
2,12,961,545.3,326,-23,303,1,waiting,20
2,12,942.3,535,117,380,497,2,waiting,20
2,12,943.7,530,445,602,1047,3,waiting,20
2,13,883.2,543.5,318,-297,21,1,waiting,20
2,13,939.6,536.9,1605,38,1643,2,waiting,20
2,14,938.5,328.7,699,-279,420,1,waiting,20
2,15,902,535.7,370,-128,242,1,waiting,20
2,15,946.7,544.5,1223,253,1476,2,waiting,20
2,16,947.6,562.1,553,-273,280,1,waiting,20
2,16,957.5,552,1485,291,1776,2,waiting,20
2,16,930.5,537.5,111,1786,1897,3,targOff,20
2,17,951.5,542.6,711,-22,689,1,waiting,20
2,17,933,557.5,228,716,944,2,waiting,20
2,17,957.4,549.6,573,953,1526,3,dotOff,20
2,18,954.3,546.9,101,-33,68,1,waiting,20
2,18,951.8,531.8,1727,137,1864,2,waiting,20
2,19,911.1,547.9,178,-104,74,1,waiting,20
2,19,958.7,554.3,200,90,290,2,waiting,20
2,19,951,544.6,487,298,785,3,waiting,20
2,19,945.1,545.4,722,792,1514,4,waiting,20
2,20,949.9,558.2,1849,-285,1564,1,waiting,20
2,21,970.3,546.5,114,-31,83,1,waiting,20
2,21,965.4,552.9,612,162,774,2,waiting,20
2,22,947.1,541.6,1944,3,1947,1,waiting,20
2,23,947.1,546,1591,22,1613,1,waiting,20
2,24,942.5,537.8,1625,-44,1581,1,waiting,20
2,25,953.6,555.3,302,-34,268,1,waiting,20
2,25,956.1,568.9,164,359,523,2,waiting,20
2,25,943.4,560.4,367,531,898,3,waiting,20
2,26,942.3,554,1258,0,1258,1,waiting,20
2,26,750.6,540.9,328,1291,1619,2,targOff,20
2,27,934.8,546.2,1831,-162,1669,1,waiting,20
2,27,945.7,533.7,121,1677,1798,2,targOff,20
2,28,946.7,543.9,2108,-280,1828,1,waiting,20
2,29,934.7,543.5,2099,-285,1814,1,waiting,20
2,30,954.1,559.6,273,-12,261,1,waiting,20
2,30,790.8,560.4,386,292,678,2,waiting,20
2,30,966.1,560.5,277,703,980,3,waiting,20
2,31,872.9,551.5,184,-157,27,1,waiting,20
2,31,940.4,535.1,1817,48,1865,2,waiting,20
2,32,938,541.9,358,-31,327,1,waiting,20
2,32,936.7,540.5,673,386,1059,2,waiting,20
2,32,952.5,547.3,877,1070,1947,3,waiting,20
2,33,953.7,552.7,1062,-272,790,1,waiting,20
2,33,963.3,557.5,682,799,1481,2,dotOff,20
2,34,949.2,551.3,2228,-281,1947,1,waiting,20
2,35,943.4,530.5,763,-59,704,1,waiting,20
2,35,940,537.4,70,823,893,2,waiting,20
2,36,957.8,546.9,793,54,847,1,waiting,20
2,37,936.3,528.7,1715,-1,1714,1,waiting,20
2,38,939.1,526.1,1491,-27,1464,1,waiting,20
2,39,938.7,541.9,1816,-285,1531,1,waiting,20
2,40,937.9,538.2,1956,-279,1677,1,waiting,20
3,1,951.9,549.8,1183,-163,1020,1,waiting,1
3,1,1093.6,544.7,388,1059,1447,2,targOff,1
3,2,971.7,559.2,223,-194,29,1,waiting,1
3,2,955.7,553.4,262,48,310,2,waiting,1
3,2,944.7,564.9,887,328,1215,3,waiting,1
3,2,786.3,563.4,463,1268,1731,4,targOff,1
3,3,950,563.1,1075,-34,1041,1,waiting,1
3,3,1116.1,556,429,1068,1497,2,targOff,1
3,4,947.7,562,1038,-18,1020,1,waiting,1
3,4,788.1,567.5,273,1072,1345,2,targOff,1
3,4,750.2,559.3,119,1379,1498,3,targOff,1
3,5,989.7,562.7,246,-231,15,1,waiting,1
3,5,957,558.7,1147,35,1182,2,waiting,1
3,5,1119.7,563.3,333,1209,1542,3,targOff,1
3,6,954.4,562.6,1162,-67,1095,1,waiting,1
3,6,777.6,569.7,486,1124,1610,2,targOff,1
3,7,937.1,559.3,1452,-78,1374,1,waiting,1
3,7,765.9,552.6,462,1419,1881,2,targOff,1
3,8,935.5,556,1066,-32,1034,1,waiting,1
3,8,1112.6,551,471,1059,1530,2,targOff,1
3,9,967.5,552.6,301,-285,16,1,waiting,1
3,9,948.7,558.9,1124,35,1159,2,waiting,1
3,9,1143.1,558.5,460,1187,1647,3,targOff,1
3,10,935.4,558.3,1683,-279,1404,1,waiting,1
3,10,1134.5,558.6,440,1453,1893,2,targOff,1
3,11,940.6,591.7,1178,-281,897,1,waiting,1
3,12,942.9,575.7,1226,19,1245,1,waiting,1
3,12,780.2,570.2,478,1286,1764,2,targOff,1
3,13,943.5,574.8,1286,-73,1213,1,waiting,1
3,13,1116.2,565.4,424,1240,1664,2,targOff,1
3,14,927.6,561.9,530,-280,250,1,waiting,1
3,14,950.6,564.5,783,269,1052,2,waiting,1
3,14,797,563.7,470,1094,1564,3,targOff,1
3,15,948.2,549,1289,-12,1277,1,waiting,1
3,15,1138.4,552.8,476,1303,1779,2,targOff,1
3,16,948.4,551.3,1532,-279,1253,1,waiting,1
3,16,1128.4,561.9,480,1280,1760,2,targOff,1
3,17,935.8,563.3,1221,-279,942,1,waiting,1
3,17,775.6,566.7,457,988,1445,2,targOff,1
3,18,955.3,557.5,1285,-43,1242,1,waiting,1
3,18,789.2,566,476,1272,1748,2,targOff,1
3,19,951,559.3,316,-58,258,1,waiting,1
3,19,956.3,562.3,714,277,991,2,waiting,1
3,19,948.1,556.4,228,998,1226,3,dotOff,1
3,19,1108.6,549.8,410,1254,1664,4,targOff,1
3,20,950.7,554.6,1342,-288,1054,1,waiting,1
3,20,795.4,553,339,1090,1429,2,waiting,1
3,20,777.2,554.3,344,1453,1797,3,targOff,1
3,21,920.2,584,236,-183,53,1,waiting,1
3,21,944.1,576.3,1139,77,1216,2,waiting,1
3,21,792.6,566.8,470,1261,1731,3,targOff,1
3,22,928,585.5,153,-50,103,1,waiting,1
3,22,949.1,583.6,228,123,351,2,waiting,1
3,22,928.7,577.5,302,378,680,3,waiting,1
3,22,942.6,583.6,313,699,1012,4,waiting,1
3,23,920.7,582.3,253,-236,17,1,waiting,1
3,23,939.7,580.4,1187,34,1221,2,waiting,1
3,23,1129.6,576.2,467,1247,1714,3,targOff,1
3,24,943.4,581.9,1372,-279,1093,1,waiting,1
3,25,923.3,556.7,227,-129,98,1,waiting,1
3,25,951.9,551.4,1210,117,1327,2,waiting,1
3,25,781.4,562.2,459,1389,1848,3,targOff,1
3,26,945.3,553.8,1511,-66,1445,1,waiting,1
3,26,1129.9,563.8,315,1482,1797,2,targOff,1
3,27,962.9,524.5,267,-39,228,1,waiting,1
3,27,947,539.3,109,246,355,2,waiting,1
3,27,944,552.5,26,416,442,3,waiting,1
3,27,952.1,563,742,464,1206,4,waiting,1
3,27,1127.1,569.7,448,1233,1681,5,targOff,1
3,28,953.8,569.1,1484,-273,1211,1,waiting,1
3,28,771.5,575.3,461,1253,1714,2,targOff,1
3,29,950.4,571.6,201,-5,196,1,waiting,1
3,29,948,568.1,169,203,372,2,waiting,1
3,29,946.8,567.1,324,391,715,3,waiting,1
3,29,946.4,561.2,624,726,1350,4,waiting,1
3,29,1144,566.5,459,1386,1845,5,targOff,1
3,30,955,520,401,-60,341,1,waiting,1
3,30,950.4,559.8,927,354,1281,2,waiting,1
3,30,782.7,561.6,495,1316,1811,3,targOff,1
3,31,938.9,572.8,595,-2,593,1,waiting,1
3,31,945.2,564.9,517,600,1117,2,waiting,1
3,31,1115.7,563.8,454,1143,1597,3,targOff,1
3,32,940.3,564.1,312,-61,251,1,waiting,1
3,32,950.4,580.7,938,269,1207,2,waiting,1
3,32,774.7,577.8,398,1250,1648,3,targOff,1
3,33,950,556.7,1376,-282,1094,1,waiting,1
3,33,779.8,563.2,459,1139,1598,2,targOff,1
3,34,953.4,556.6,1360,-25,1335,1,waiting,1
3,34,778,549.4,464,1367,1831,2,targOff,1
3,35,950.5,564.4,1568,-279,1289,1,waiting,1
3,35,777.6,567.2,482,1345,1827,2,targOff,1
3,36,949,559.7,1565,-279,1286,1,waiting,1
3,36,1114.2,553.9,451,1312,1763,2,targOff,1
3,37,952.5,563.8,1660,-278,1382,1,waiting,1
3,37,1120.7,550.7,454,1406,1860,2,targOff,1
3,38,943,563.9,1112,-20,1092,1,waiting,1
3,38,784,567.5,476,1122,1598,2,targOff,1
3,39,944.6,574.9,1392,-273,1119,1,waiting,1
3,39,1117,567.7,455,1159,1614,2,targOff,1
3,40,957.8,549.4,1538,-286,1252,1,waiting,1
3,40,773.4,564.4,468,1296,1764,2,targOff,1
3,1,950.8,565.8,1553,-200,1353,1,waiting,2
3,1,940.3,567.7,232,1362,1594,2,targOff,2
3,2,941.8,568.8,262,-22,240,1,waiting,2
3,2,941,568.8,1318,247,1565,2,waiting,2
3,3,952.8,569.5,768,-4,764,1,waiting,2
3,3,939.2,561.9,1079,785,1864,2,waiting,2
3,4,940.6,578.6,946,-231,715,1,waiting,2
3,4,943.9,566.7,915,734,1649,2,waiting,2
3,5,940.5,572.3,2028,-283,1745,1,waiting,2
3,5,954.9,562,183,1765,1948,2,targOff,2
3,6,938.8,573.9,1716,-284,1432,1,waiting,2
3,6,957.2,577.3,197,1448,1645,2,targOff,2
3,7,943.3,573.9,1822,-58,1764,1,waiting,2
3,8,946.6,553.6,1936,-288,1648,1,waiting,2
3,9,951.4,553.3,1974,-277,1697,1,waiting,2
3,10,950.3,556.8,1837,-206,1631,1,waiting,2
3,11,951.4,554.8,686,-270,416,1,waiting,2
3,11,948.6,560.9,1141,423,1564,2,waiting,2
3,12,941.9,568.8,2135,-288,1847,1,waiting,2
3,13,944.3,574.4,2220,-272,1948,1,waiting,2
3,14,951.3,579.2,1147,-283,864,1,waiting,2
3,15,968.9,577.2,336,-276,60,1,waiting,2
3,15,949.8,568.6,1848,79,1927,2,waiting,2
3,16,941,582.2,966,-69,897,1,waiting,2
3,17,954.8,590.3,1064,-100,964,1,waiting,2
3,18,947.4,575.7,1854,-275,1579,1,waiting,2
3,19,938.9,583.4,808,-27,781,1,waiting,2
3,20,942.8,576.2,1437,27,1464,1,waiting,2
3,21,944.5,558.8,315,-273,42,1,waiting,2
3,21,959.1,552.7,1501,63,1564,2,waiting,2
3,22,955.1,555.9,1839,-25,1814,1,waiting,2
3,23,946.7,566,1818,-288,1530,1,waiting,2
3,23,747.4,559.5,232,1582,1814,2,targOff,2
3,24,973.3,567.8,298,-276,22,1,waiting,2
3,24,954.7,565.1,1394,48,1442,2,waiting,2
3,24,1087.7,563.7,211,1465,1676,3,targOff,2
3,25,951.7,553.9,2000,-286,1714,1,waiting,2
3,26,945.3,555.9,274,-31,243,1,waiting,2
3,26,953.1,565.6,1485,262,1747,2,waiting,2
3,27,947.6,555.5,606,-9,597,1,waiting,2
3,27,939.3,561.4,845,619,1464,2,waiting,2
3,28,952.7,554.9,1980,-282,1698,1,waiting,2
3,29,953.1,554,1456,-279,1177,1,waiting,2
3,29,951.1,554.8,615,1197,1812,2,dotOff,2
3,30,950,554.6,1939,-191,1748,1,waiting,2
3,31,954,559.5,1743,-246,1497,1,waiting,2
3,32,946,564.6,1766,-285,1481,1,waiting,2
3,33,949.4,560.3,1922,-277,1645,1,waiting,2
3,34,947.8,569.8,1325,-62,1263,1,waiting,2
3,34,949.5,569.9,465,1282,1747,2,targOff,2
3,35,947.2,559.9,439,-50,389,1,waiting,2
3,35,902,565.1,166,416,582,2,waiting,2
3,35,953.4,565.4,996,601,1597,3,waiting,2
3,36,944.7,565,1554,-23,1531,1,waiting,2
3,37,952,571,1925,-276,1649,1,waiting,2
3,37,931.3,543.3,211,1670,1881,2,targOff,2
3,38,943.7,563.5,694,-64,630,1,waiting,2
3,38,953.4,567,1125,672,1797,2,waiting,2
3,39,938.9,566.2,606,-34,572,1,waiting,2
3,39,955.4,564.4,1239,591,1830,2,waiting,2
3,40,951.5,565,1926,-28,1898,1,waiting,2
3,1,929.3,544.6,266,-241,25,1,waiting,3
3,1,958.1,553,1212,47,1259,2,waiting,3
3,1,1125.2,560.5,459,1286,1745,3,targOff,3
3,2,949,561.4,1391,-286,1105,1,waiting,3
3,2,1128.6,559.9,493,1137,1630,2,targOff,3
3,3,942.4,562.1,1037,-21,1016,1,waiting,3
3,3,1109.7,554.3,434,1044,1478,2,targOff,3
3,4,946,562.3,1623,-271,1352,1,waiting,3
3,4,771.3,561.1,453,1411,1864,2,targOff,3
3,5,946.1,552.1,1424,-279,1145,1,waiting,3
3,5,1121.6,562.5,486,1178,1664,2,targOff,3
3,6,944.3,551.1,1393,-281,1112,1,waiting,3
3,6,770,556.4,457,1158,1615,2,targOff,3
3,7,945.2,556.7,1172,-32,1140,1,waiting,3
3,7,778.1,554.5,462,1169,1631,2,targOff,3
3,8,948,563.4,1046,-51,995,1,waiting,3
3,8,1127.8,569,457,1022,1479,2,targOff,3
3,9,937.2,577.9,444,-278,166,1,waiting,3
3,9,953.2,554.5,35,178,213,2,waiting,3
3,9,938.4,583.6,771,256,1027,3,waiting,3
3,10,958.1,568.2,1371,25,1396,1,waiting,3
3,10,1132.4,574.5,447,1434,1881,2,targOff,3
3,11,949.3,562.3,1249,-269,980,1,waiting,3
3,11,785.5,565.6,424,1024,1448,2,targOff,3
3,12,949.4,564,1278,-288,990,1,waiting,3
3,12,1117.1,557.2,430,1017,1447,2,targOff,3
3,13,942.7,564.4,1231,-67,1164,1,waiting,3
3,13,1115.4,578.6,439,1191,1630,2,targOff,3
3,14,951.6,563.6,275,-23,252,1,waiting,3
3,14,939.5,563.3,967,259,1226,2,waiting,3
3,14,791.4,558.2,443,1255,1698,3,targOff,3
3,15,946.1,569,2087,-273,1814,1,waiting,3
3,16,969.8,551.9,278,-271,7,1,waiting,3
3,16,954.8,551.3,412,30,442,2,waiting,3
3,16,948.8,555.6,699,462,1161,3,waiting,3
3,16,777.9,557.3,474,1207,1681,4,targOff,3
3,17,943.5,556.3,1534,-282,1252,1,waiting,3
3,17,1098,558,419,1290,1709,2,targOff,3
3,18,955.3,559,317,-286,31,1,waiting,3
3,18,947.8,556.9,1034,50,1084,2,waiting,3
3,18,1136.5,568.6,470,1110,1580,3,targOff,3
3,19,949.4,558.2,1306,-277,1029,1,waiting,3
3,19,774.4,562.3,442,1088,1530,2,targOff,3
3,20,941.7,561.3,1350,-61,1289,1,waiting,3
3,20,1129.4,557.9,482,1315,1797,2,targOff,3
3,21,951.3,556.9,1534,-106,1428,1,waiting,3
3,21,1114.7,568.3,444,1454,1898,2,targOff,3
3,22,945.5,562,1482,-279,1203,1,waiting,3
3,22,1087,553.8,387,1227,1614,2,targOff,3
3,23,994,552.4,247,-235,12,1,waiting,3
3,23,949.5,557.2,1300,35,1335,2,waiting,3
3,23,757.5,552.5,454,1393,1847,3,targOff,3
3,24,893.5,591.2,243,-225,18,1,waiting,3
3,24,947.4,573.4,1178,40,1218,2,waiting,3
3,24,1139.7,572.1,454,1243,1697,3,targOff,3
3,25,953.2,569.1,1113,-270,843,1,waiting,3
3,25,946.8,563.5,170,851,1021,2,dotOff,3
3,25,782.6,565.6,415,1049,1464,3,targOff,3
3,26,963.2,562.2,481,-278,203,1,waiting,3
3,26,948.2,564.4,184,221,405,2,waiting,3
3,26,944.1,561.2,791,424,1215,3,waiting,3
3,26,1120,578.6,450,1243,1693,4,targOff,3
3,27,944.3,557.7,1426,-264,1162,1,waiting,3
3,27,1136.4,565.3,455,1191,1646,2,targOff,3
3,28,945.7,563.2,691,-275,416,1,waiting,3
3,28,944.8,563,580,423,1003,2,waiting,3
3,28,1111.5,576.8,434,1030,1464,3,targOff,3
3,29,949.1,559.6,1687,-270,1417,1,waiting,3
3,29,1123.3,566.7,394,1441,1835,2,targOff,3
3,29,1027.8,566.6,72,1859,1931,3,targOff,3
3,30,962.1,568.2,1443,-295,1148,1,waiting,3
3,30,1113.7,569.9,483,1176,1659,2,targOff,3
3,31,962.9,562.8,178,16,194,1,waiting,3
3,31,955.3,559.9,802,201,1003,2,waiting,3
3,31,791.8,564.4,341,1054,1395,3,targOff,3
3,31,757.7,553.9,89,1425,1514,4,targOff,3
3,32,959.4,575.2,297,-287,10,1,waiting,3
3,32,950.2,567.9,943,30,973,2,waiting,3
3,32,788.3,568.5,409,1019,1428,3,targOff,3
3,32,775.8,563.5,45,1452,1497,4,targOff,3
3,33,949,570.4,1294,-276,1018,1,waiting,3
3,33,1106.4,564.7,421,1043,1464,2,targOff,3
3,34,941.9,587,1183,-269,914,1,waiting,3
3,35,952.4,571.5,788,-110,678,1,waiting,3
3,35,943.9,566.7,625,697,1322,2,waiting,3
3,35,785.9,568.4,384,1351,1735,3,targOff,3
3,35,759.4,570.1,85,1762,1847,4,targOff,3
3,36,936.9,576.1,312,-289,23,1,waiting,3
3,36,952.7,566.7,1261,43,1304,2,waiting,3
3,36,1122.6,575.1,498,1332,1830,3,targOff,3
3,37,945.8,577.1,1557,-201,1356,1,waiting,3
3,37,774.6,569.8,447,1400,1847,2,targOff,3
3,38,950.8,563.4,1193,-270,923,1,waiting,3
3,38,968.5,563.8,199,930,1129,2,waiting,3
3,38,760,575.3,438,1177,1615,3,targOff,3
3,39,906.7,591.4,263,-262,1,1,waiting,3
3,39,942.2,578.8,1109,21,1130,2,waiting,3
3,39,793.8,579.3,438,1174,1612,3,targOff,3
3,40,947,587.4,1267,-286,981,1,waiting,3
3,1,957.4,542.3,195,12,207,1,waiting,4
3,1,944.2,537.2,1334,216,1550,2,waiting,4
3,1,750.4,537.6,216,1599,1815,3,targOff,4
3,2,947.6,529.9,1625,-11,1614,1,waiting,4
3,3,940.1,560.6,1804,-271,1533,1,waiting,4
3,3,936.2,548.6,228,1553,1781,2,targOff,4
3,4,946.2,544.6,1845,-283,1562,1,waiting,4
3,4,948.2,549.2,245,1586,1831,2,targOff,4
3,5,940.5,535.1,1933,-286,1647,1,waiting,4
3,6,941.4,539.3,304,-264,40,1,waiting,4
3,6,939.1,537.2,997,60,1057,2,waiting,4
3,6,933.7,535.9,450,1076,1526,3,targOff,4
3,7,933.8,540,1811,-288,1523,1,waiting,4
3,7,939,535.2,219,1545,1764,2,targOff,4
3,8,941.8,540.8,1970,-89,1881,1,waiting,4
3,9,938.8,544.4,1948,-34,1914,1,waiting,4
3,10,938.5,536.2,1485,-26,1459,1,waiting,4
3,11,937,540.5,1983,-280,1703,1,waiting,4
3,11,950.8,538.2,202,1724,1926,2,targOff,4
3,12,936.2,538.7,1965,-279,1686,1,waiting,4
3,13,936.6,536.9,1832,-168,1664,1,waiting,4
3,14,933.6,544.6,1842,-28,1814,1,waiting,4
3,15,939.7,550.2,1670,-280,1390,1,waiting,4
3,15,953.7,540.1,238,1409,1647,2,targOff,4
3,16,938.7,536.5,528,-281,247,1,waiting,4
3,16,946.1,551.5,1567,264,1831,2,waiting,4
3,17,946.3,540.4,2014,-84,1930,1,waiting,4
3,18,950.3,560.6,474,-85,389,1,waiting,4
3,18,938,551.9,1157,408,1565,2,waiting,4
3,19,949.6,550.3,301,-278,23,1,waiting,4
3,19,935.7,550.4,1650,47,1697,2,waiting,4
3,20,937.8,549.9,1245,-278,967,1,waiting,4
3,20,936.4,553.1,757,990,1747,2,waiting,4
3,21,947.5,538.3,757,-259,498,1,waiting,4
3,21,944.7,542.9,1059,505,1564,2,waiting,4
3,22,941.8,554.2,1894,-280,1614,1,waiting,4
3,23,944,559,1834,-269,1565,1,waiting,4
3,24,944.4,555.4,1654,-275,1379,1,waiting,4
3,24,982.1,549.4,171,1395,1566,2,targOff,4
3,24,927.4,556.2,211,1587,1798,3,targOff,4
3,25,941.1,569.7,729,-281,448,1,waiting,4
3,25,939.1,556.7,932,466,1398,2,waiting,4
3,25,944.2,557.2,179,1419,1598,3,targOff,4
3,26,940,561.4,1528,-14,1514,1,waiting,4
3,27,936.1,550.4,1889,-296,1593,1,waiting,4
3,28,946.4,540.8,2127,-280,1847,1,waiting,4
3,29,939.1,561,1773,-211,1562,1,waiting,4
3,29,941.6,567.2,284,1581,1865,2,targOff,4
3,30,935.8,562.6,1806,-275,1531,1,waiting,4
3,31,938,567.6,1755,-27,1728,1,waiting,4
3,31,929.1,559.5,166,1748,1914,2,targOff,4
3,32,939.8,567.5,1735,-5,1730,1,waiting,4
3,33,942.6,561,1936,-281,1655,1,waiting,4
3,33,931.1,550.3,133,1663,1796,2,targOff,4
3,34,941.9,552.1,1735,-88,1647,1,waiting,4
3,35,940.7,543.3,1934,-269,1665,1,waiting,4
3,35,954.2,489.6,57,1741,1798,2,targOff,4
3,36,943.1,560.6,1759,-162,1597,1,waiting,4
3,37,939.4,546.5,583,-283,300,1,waiting,4
3,37,941.5,541.3,1329,318,1647,2,waiting,4
3,38,936,567.8,1595,-132,1463,1,waiting,4
3,39,957.8,557.6,202,-105,97,1,waiting,4
3,39,945.8,543,1300,106,1406,2,waiting,4
3,39,955.4,537.6,182,1428,1610,3,targOff,4
3,40,944.8,541.5,1782,-272,1510,1,waiting,4
3,40,939,533,216,1532,1748,2,targOff,4
3,1,960.7,538.6,306,-122,184,1,waiting,5
3,1,936.9,545.7,190,194,384,2,waiting,5
3,1,953.8,547.4,759,392,1151,3,waiting,5
3,1,766,548.4,439,1208,1647,4,targOff,5
3,2,940.6,538.9,1258,-282,976,1,waiting,5
3,2,758,546.2,426,1021,1447,2,targOff,5
3,3,944.3,539.3,1554,-272,1282,1,waiting,5
3,3,772.8,538.1,488,1327,1815,2,targOff,5
3,4,941.3,550.3,1273,-58,1215,1,waiting,5
3,4,761.8,538.8,452,1263,1715,2,targOff,5
3,5,931.6,542.5,490,-62,428,1,waiting,5
3,5,945.9,550.1,697,446,1143,2,waiting,5
3,5,757.6,556.7,474,1190,1664,3,targOff,5
3,6,942.5,532.9,1456,-48,1408,1,waiting,5
3,6,1126.8,538.5,462,1435,1897,2,targOff,5
3,7,941.3,533.2,1306,-272,1034,1,waiting,5
3,7,769.2,539.4,453,1061,1514,2,targOff,5
3,8,939.7,540.6,295,-60,235,1,waiting,5
3,8,953.2,544.5,406,251,657,2,waiting,5
3,8,944.9,537,694,677,1371,3,waiting,5
3,8,1115.1,540.9,485,1396,1881,4,targOff,5
3,9,942.5,530,933,2,935,1,waiting,5
3,9,921.4,532.5,305,952,1257,2,waiting,5
3,9,1119.8,536.7,446,1284,1730,3,targOff,5
3,10,951.2,538.6,1351,-288,1063,1,waiting,5
3,10,1129.4,544.7,477,1087,1564,2,targOff,5
3,11,946.6,550.3,1529,-17,1512,1,waiting,5
3,12,948,550.2,178,-117,61,1,waiting,5
3,12,949.7,538,898,70,968,2,waiting,5
3,12,759.6,548.8,303,993,1296,3,targOff,5
3,12,742.3,547.6,167,1314,1481,4,targOff,5
3,13,944.7,543.5,1063,6,1069,1,waiting,5
3,13,755.8,547.1,449,1115,1564,2,targOff,5
3,14,938.4,536.4,1121,3,1124,1,waiting,5
3,14,1107.7,539.3,420,1162,1582,2,targOff,5
3,15,957.3,524,304,-287,17,1,waiting,5
3,15,945.3,527.9,1330,37,1367,2,waiting,5
3,15,1101.4,538.1,420,1394,1814,3,targOff,5
3,16,958.2,566.5,297,-278,19,1,waiting,5
3,16,940.6,554,953,40,993,2,waiting,5
3,16,763.2,538,425,1039,1464,3,targOff,5
3,17,943.9,549.6,172,12,184,1,waiting,5
3,17,930.5,550.2,544,193,737,2,waiting,5
3,17,950.8,554.9,364,754,1118,3,waiting,5
3,17,752.4,553.8,474,1154,1628,4,targOff,5
3,18,863.8,560.1,281,-281,0,1,waiting,5
3,18,923.3,555.6,155,30,185,2,waiting,5
3,18,953.6,551.8,317,203,520,3,waiting,5
3,18,943.2,550.1,609,538,1147,4,waiting,5
3,18,1106.3,563,331,1184,1515,5,targOff,5
3,18,1109.8,554.3,45,1536,1581,6,targOff,5
3,19,955.1,542.6,1384,-279,1105,1,waiting,5
3,19,1121.6,559.5,432,1132,1564,2,targOff,5
3,20,955.8,547.4,1491,-270,1221,1,waiting,5
3,20,1125.4,550.4,481,1250,1731,2,targOff,5
3,21,944.9,563.4,1202,-278,924,1,waiting,5
3,21,962.7,560.2,432,944,1376,2,waiting,5
3,21,759.9,558.9,324,1423,1747,3,targOff,5
3,22,922.8,554.8,304,-281,23,1,waiting,5
3,22,949.4,556.7,1137,42,1179,2,waiting,5
3,22,765.9,556.4,453,1227,1680,3,targOff,5
3,23,925,556.7,250,-48,202,1,waiting,5
3,23,943.2,554.2,337,219,556,2,waiting,5
3,23,933.9,551.1,388,575,963,3,waiting,5
3,23,752.5,549.5,454,1009,1463,4,targOff,5
3,24,946.4,559.8,1184,-153,1031,1,waiting,5
3,24,761.7,568.9,439,1092,1531,2,targOff,5
3,25,949.4,552.7,309,-271,38,1,waiting,5
3,25,944.2,542,887,44,931,2,waiting,5
3,25,753.9,548.7,481,967,1448,3,targOff,5
3,26,949.5,557.2,1063,-4,1059,1,waiting,5
3,26,768.5,549.4,293,1105,1398,2,targOff,5
3,26,751.9,546.3,157,1425,1582,3,targOff,5
3,27,939.4,554.2,1126,12,1138,1,waiting,5
3,27,755.8,541.8,449,1198,1647,2,targOff,5
3,28,952.9,529.7,303,-282,21,1,waiting,5
3,28,953.8,531.1,1235,39,1274,2,waiting,5
3,28,738.1,535.7,457,1324,1781,3,targOff,5
3,29,924.2,538.2,525,-273,252,1,waiting,5
3,29,952.2,562.7,982,267,1249,2,waiting,5
3,29,1127.1,561.2,487,1277,1764,3,targOff,5
3,30,953.6,560.3,1105,-18,1087,1,waiting,5
3,30,1105.9,561.5,389,1109,1498,2,waiting,5
3,30,1135.3,569.3,397,1517,1914,3,targOff,5
3,31,957.6,562.1,1433,-155,1278,1,waiting,5
3,31,1145,564.9,460,1304,1764,2,targOff,5
3,32,962.2,561.3,638,-286,352,1,waiting,5
3,32,957.5,560.2,636,371,1007,2,waiting,5
3,32,1134.8,566.9,464,1033,1497,3,targOff,5
3,33,945.5,572.5,1265,-283,982,1,waiting,5
3,33,754.5,567.9,452,1029,1481,2,targOff,5
3,34,992.3,554.3,283,-282,1,1,waiting,5
3,34,945.4,567.2,1119,32,1151,2,waiting,5
3,34,1118.9,569.4,336,1178,1514,3,targOff,5
3,35,941.6,579.5,1111,12,1123,1,waiting,5
3,35,777.2,582.7,462,1166,1628,2,targOff,5
3,36,941.9,560.1,1240,-34,1206,1,waiting,5
3,36,765.8,579.1,477,1254,1731,2,targOff,5
3,37,941.1,565.2,1021,-279,742,1,waiting,5
3,37,933.1,563.1,308,760,1068,2,waiting,5
3,37,1113.3,567.6,421,1094,1515,3,targOff,5
3,38,942.3,567.4,1688,-271,1417,1,waiting,5
3,38,773,570.4,462,1469,1931,2,targOff,5
3,39,942.6,569.9,1243,13,1256,1,waiting,5
3,39,1119.8,563.6,482,1282,1764,2,targOff,5
3,40,936,559.9,518,-279,239,1,waiting,5
3,40,948.7,553.8,915,258,1173,2,waiting,5
3,40,758.7,576,479,1202,1681,3,targOff,5
3,1,1028.5,527.9,233,-219,14,1,waiting,6
3,1,971.7,518.9,164,37,201,2,waiting,6
3,1,974.9,522.5,1097,207,1304,3,waiting,6
3,1,820.5,518.1,280,1350,1630,4,targOff,6
3,2,961.4,534.3,1886,-272,1614,1,waiting,6
3,3,965.7,527.9,1596,-285,1311,1,waiting,6
3,3,969.2,526,180,1334,1514,2,targOff,6
3,4,966.8,532.9,2120,-272,1848,1,waiting,6
3,5,958.5,527.3,1769,-289,1480,1,waiting,6
3,6,948.8,532.2,93,-35,58,1,waiting,6
3,6,967.6,525.6,1671,76,1747,2,waiting,6
3,7,962,540.2,666,-205,461,1,waiting,6
3,7,966.2,524,202,506,708,2,waiting,6
3,7,969.1,511,62,715,777,3,waiting,6
3,7,970,522.6,71,801,872,4,waiting,6
3,7,962.8,534.5,579,935,1514,5,dotOff,6
3,8,959.9,522.2,1705,-146,1559,1,waiting,6
3,8,957.4,535.4,214,1567,1781,2,targOff,6
3,9,968.2,529.5,1435,-37,1398,1,waiting,6
3,9,957.6,526.3,238,1410,1648,2,targOff,6
3,10,965,520.4,1515,-282,1233,1,waiting,6
3,10,974,526.3,196,1252,1448,2,targOff,6
3,11,959,530.2,1682,-284,1398,1,waiting,6
3,11,963.7,530.9,174,1419,1593,2,targOff,6
3,12,964.3,523.1,2132,-284,1848,1,waiting,6
3,13,963,528.7,1370,-80,1290,1,waiting,6
3,13,981.4,528,208,1306,1514,2,targOff,6
3,14,973.3,528.6,974,-280,694,1,waiting,6
3,14,956.1,528.5,832,711,1543,2,waiting,6
3,15,960.8,525,1787,-273,1514,1,waiting,6
3,16,966.5,534.8,1751,-91,1660,1,waiting,6
3,16,973.5,523,203,1678,1881,2,targOff,6
3,17,963.5,534.7,1764,-279,1485,1,waiting,6
3,17,959,538.7,250,1509,1759,2,targOff,6
3,18,965.3,537.2,285,-285,0,1,waiting,6
3,18,954.2,531.2,1658,19,1677,2,waiting,6
3,19,957.4,528.5,1771,-73,1698,1,waiting,6
3,20,962.4,529.1,1992,-278,1714,1,waiting,6
3,21,962.5,535.1,339,-83,256,1,waiting,6
3,21,958.4,529.9,349,263,612,2,waiting,6
3,21,967.1,525.5,993,621,1614,3,waiting,6
3,22,959.2,537.9,1953,-39,1914,1,waiting,6
3,23,954.2,540.7,2165,-284,1881,1,waiting,6
3,24,955.3,544.8,1651,-72,1579,1,waiting,6
3,25,957.2,543.8,1971,-274,1697,1,waiting,6
3,26,963.4,541.8,1669,-38,1631,1,waiting,6
3,27,968.2,546.9,1818,-271,1547,1,waiting,6
3,28,960.5,551.6,1360,-75,1285,1,waiting,6
3,28,960,554.3,240,1307,1547,2,targOff,6
3,29,957.8,545,2146,-285,1861,1,waiting,6
3,30,963.7,538.9,1090,-74,1016,1,waiting,6
3,30,961.4,537.6,842,1037,1879,2,waiting,6
3,31,963.4,534,1978,-283,1695,1,waiting,6
3,31,959.7,529.1,207,1724,1931,2,targOff,6
3,32,967.7,532.4,313,-285,28,1,waiting,6
3,32,964.1,517.5,326,37,363,2,waiting,6
3,32,969.6,494.5,295,371,666,3,waiting,6
3,32,964,543.8,556,678,1234,4,waiting,6
3,32,950.2,550,250,1253,1503,5,waiting,6
3,32,981.3,543.2,192,1519,1711,6,targOff,6
3,32,964.9,537.9,209,1738,1947,7,targOff,6
3,33,955,556.3,517,-283,234,1,waiting,6
3,33,954.2,540.1,240,254,494,2,waiting,6
3,33,960.3,542.8,1243,504,1747,3,waiting,6
3,34,960.9,535.8,1888,-59,1829,1,waiting,6
3,35,935.2,530.3,123,-96,27,1,waiting,6
3,35,953.6,537.6,1213,36,1249,2,waiting,6
3,35,966.2,538.2,194,1269,1463,3,targOff,6
3,36,958.3,538.1,2109,-279,1830,1,waiting,6
3,37,960.3,544.2,498,-284,214,1,waiting,6
3,37,951.7,535.9,1219,231,1450,2,waiting,6
3,37,946.9,530.5,174,1457,1631,3,targOff,6
3,38,956.1,533.8,1563,18,1581,1,waiting,6
3,39,963.2,525.2,948,-280,668,1,waiting,6
3,39,954.9,530.2,1063,684,1747,2,waiting,6
3,40,952,537.6,1610,5,1615,1,waiting,6
3,1,953.4,529,1485,-284,1201,1,waiting,7
3,1,777.7,533.1,448,1250,1698,2,targOff,7
3,2,946.3,525.1,714,-282,432,1,waiting,7
3,2,947.7,531.5,862,451,1313,2,waiting,7
3,2,1117.8,537.1,441,1340,1781,3,targOff,7
3,3,949.7,533.6,1434,-291,1143,1,waiting,7
3,3,1125.3,531.9,442,1169,1611,2,targOff,7
3,4,959.3,549.5,531,-269,262,1,waiting,7
3,4,955.1,538.9,948,278,1226,2,waiting,7
3,4,1134,543.7,511,1253,1764,3,targOff,7
3,5,947.8,534.2,1547,-280,1267,1,waiting,7
3,5,767.7,527.3,458,1320,1778,2,targOff,7
3,6,946.3,533,1453,-48,1405,1,waiting,7
3,6,773.2,541.4,477,1454,1931,2,targOff,7
3,7,952.4,532.1,1312,-27,1285,1,waiting,7
3,7,1094.5,528.8,299,1309,1608,2,targOff,7
3,7,1155.9,529.7,97,1634,1731,3,targOff,7
3,8,949.4,534,1531,-283,1248,1,waiting,7
3,8,779.4,536.7,485,1279,1764,2,targOff,7
3,9,952.4,532.2,587,-284,303,1,waiting,7
3,9,955.3,536.3,1018,313,1331,2,waiting,7
3,9,1146.5,535.1,455,1359,1814,3,targOff,7
3,10,948.3,532.1,1367,-281,1086,1,waiting,7
3,10,1112,529.7,292,1111,1403,2,targOff,7
3,10,1152,523.8,104,1427,1531,3,targOff,7
3,11,952,537.8,1201,-47,1154,1,waiting,7
3,11,1090.7,534.4,419,1179,1598,2,targOff,7
3,12,959.6,534.2,1179,-13,1166,1,waiting,7
3,12,1144.9,535.4,306,1192,1498,2,targOff,7
3,12,1015.1,525.6,121,1522,1643,3,targOff,7
3,13,957,528,1448,-285,1163,1,waiting,7
3,13,1154.8,534,458,1190,1648,2,targOff,7
3,14,950.3,535.3,1194,-7,1187,1,waiting,7
3,14,771.8,531.9,460,1237,1697,2,targOff,7
3,15,953.3,532.7,1222,2,1224,1,waiting,7
3,15,784.6,540.8,458,1256,1714,2,targOff,7
3,16,950.2,529.3,1244,-26,1218,1,waiting,7
3,16,1141.3,541.9,452,1246,1698,2,targOff,7
3,17,945.9,535.7,1239,-56,1183,1,waiting,7
3,17,1111.2,530.2,344,1220,1564,2,targOff,7
3,18,952,539,1198,11,1209,1,waiting,7
3,18,777.6,533,491,1256,1747,2,targOff,7
3,19,957.7,529.1,306,-285,21,1,waiting,7
3,19,951.7,527.8,1025,40,1065,2,waiting,7
3,19,779.1,539.6,439,1109,1548,3,targOff,7
3,20,949.5,532.9,58,-55,3,1,waiting,7
3,20,950.3,481.6,153,74,227,2,waiting,7
3,20,964.2,481.6,1038,245,1283,3,waiting,7
3,20,960,528.8,63,1333,1396,4,dotOff,7
3,20,785.9,540.6,210,1481,1691,5,targOff,7
3,20,790.2,535.3,117,1704,1821,6,targOff,7
3,20,789.8,530.5,82,1832,1914,7,targOff,7
3,21,955,532.9,1473,-285,1188,1,waiting,7
3,21,783.7,534.6,463,1234,1697,2,targOff,7
3,22,962.9,525.7,892,-284,608,1,waiting,7
3,22,953.4,523,558,624,1182,2,waiting,7
3,22,779.2,531.9,434,1230,1664,3,targOff,7
3,23,956.3,534.3,1413,-287,1126,1,waiting,7
3,23,1108.6,531.2,413,1151,1564,2,targOff,7
3,24,954.2,531.2,1112,-7,1105,1,waiting,7
3,24,785.8,529.2,499,1131,1630,2,targOff,7
3,25,951.5,535,1332,-75,1257,1,waiting,7
3,25,773.9,540,209,1305,1514,2,targOff,7
3,26,957,530.1,663,-278,385,1,waiting,7
3,26,945.2,527.7,459,404,863,2,waiting,7
3,26,931.4,527,163,878,1041,3,waiting,7
3,26,1106,530.9,317,1082,1399,4,waiting,7
3,26,1129.2,545.1,357,1420,1777,5,targOff,7
3,27,959.2,533.1,1072,15,1087,1,waiting,7
3,27,1158.7,538.6,364,1117,1481,2,targOff,7
3,28,958.2,539.3,1485,-270,1215,1,waiting,7
3,28,1148.2,541.1,470,1244,1714,2,targOff,7
3,29,953.4,537.9,1537,-282,1255,1,waiting,7
3,29,1134.9,533.9,482,1281,1763,2,targOff,7
3,30,954.8,532.4,1153,-32,1121,1,waiting,7
3,30,1121.5,534.9,290,1146,1436,2,targOff,7
3,30,1158.3,529.9,104,1460,1564,3,targOff,7
3,31,951.9,533.3,1600,-272,1328,1,waiting,7
3,31,769.9,538.6,470,1377,1847,2,targOff,7
3,32,949,544,1464,-283,1181,1,waiting,7
3,32,1130.2,544.7,473,1208,1681,2,targOff,7
3,33,952.2,536.2,1445,-289,1156,1,waiting,7
3,33,1137.7,533.5,465,1182,1647,2,targOff,7
3,34,950.9,530.6,1248,-282,966,1,waiting,7
3,34,1132.9,528.3,453,994,1447,2,targOff,7
3,35,954.4,476.4,169,-1,168,1,waiting,7
3,35,949.7,517.8,30,201,231,2,waiting,7
3,35,950.3,540.3,1046,257,1303,3,waiting,7
3,35,797.6,546.5,483,1348,1831,4,targOff,7
3,36,948.6,537,1397,-31,1366,1,waiting,7
3,36,1122.7,537.7,455,1392,1847,2,targOff,7
3,37,932.2,543.4,336,-272,64,1,waiting,7
3,37,951.4,540.4,992,82,1074,2,waiting,7
3,37,793.2,533.2,464,1100,1564,3,targOff,7
3,38,951.1,538.2,782,-31,751,1,waiting,7
3,38,943.1,542.5,385,770,1155,2,waiting,7
3,38,777.9,545.4,476,1188,1664,3,targOff,7
3,39,952.2,530,1329,-285,1044,1,waiting,7
3,39,1151.3,540.8,455,1076,1531,2,targOff,7
3,40,963.4,538.8,312,-23,289,1,waiting,7
3,40,954.3,539.5,1189,308,1497,2,waiting,7
3,40,1082.5,541,188,1519,1707,3,targOff,7
3,40,1141.7,536.9,199,1732,1931,4,targOff,7
3,1,949.1,527.5,1644,20,1664,1,waiting,8
3,2,954,531.6,307,-279,28,1,waiting,8
3,2,950.1,537,1518,46,1564,2,waiting,8
3,3,951.5,534.3,1843,-280,1563,1,waiting,8
3,4,941.4,550.3,1860,-279,1581,1,waiting,8
3,5,947.5,542.3,1394,-273,1121,1,waiting,8
3,5,949,532.5,592,1140,1732,2,dotOff,8
3,6,941.1,536.7,265,-258,7,1,waiting,8
3,6,951.8,536.7,221,22,243,2,waiting,8
3,6,943,538.7,1254,261,1515,3,waiting,8
3,7,948.3,529.5,1802,-21,1781,1,waiting,8
3,8,943.8,523.6,1802,-22,1780,1,waiting,8
3,9,946.5,530.9,1767,-270,1497,1,waiting,8
3,10,948.2,538.5,2177,-280,1897,1,waiting,8
3,11,947.3,530.5,1889,-275,1614,1,waiting,8
3,12,949.4,527.6,1773,-26,1747,1,waiting,8
3,13,941.3,525.8,1063,-283,780,1,waiting,8
3,13,940.3,530.1,1099,799,1898,2,waiting,8
3,14,955.8,552.6,258,-8,250,1,waiting,8
3,14,945.7,549.2,1172,267,1439,2,waiting,8
3,14,798.2,547.7,145,1468,1613,3,targOff,8
3,15,940.5,552.3,729,-108,621,1,waiting,8
3,15,948.7,542.1,1236,628,1864,2,waiting,8
3,16,944.3,534.8,1913,-282,1631,1,waiting,8
3,17,956.8,536.2,908,-31,877,1,waiting,8
3,17,946.3,537.8,635,960,1595,2,dotOff,8
3,18,898.9,545.8,202,-191,11,1,waiting,8
3,18,951.7,539.4,1713,35,1748,2,waiting,8
3,19,944.5,541.3,1946,-282,1664,1,waiting,8
3,20,945.4,543,423,-17,406,1,waiting,8
3,20,951.6,536,1472,425,1897,2,waiting,8
3,21,939.1,534.2,285,-283,2,1,waiting,8
3,21,947.2,536.9,1435,22,1457,2,waiting,8
3,21,953.3,544.1,187,1477,1664,3,targOff,8
3,22,956.3,541.7,1759,-280,1479,1,waiting,8
3,23,942.5,536.8,1927,-279,1648,1,waiting,8
3,24,945.7,512.8,53,-28,25,1,waiting,8
3,24,951.3,506.2,57,41,98,2,waiting,8
3,24,953.3,510.3,29,181,210,3,waiting,8
3,24,951.4,510.3,20,235,255,4,waiting,8
3,24,949.3,543.8,98,298,396,5,waiting,8
3,24,942.8,540.6,1165,416,1581,6,waiting,8
3,25,951.3,536.1,849,-279,570,1,waiting,8
3,25,944.8,544.3,857,590,1447,2,waiting,8
3,26,948,537.2,2145,-281,1864,1,waiting,8
3,27,957,539,2005,-275,1730,1,waiting,8
3,28,933.9,540.2,2060,-279,1781,1,waiting,8
3,29,952.6,537.3,2027,-279,1748,1,waiting,8
3,30,944.4,536.6,1708,-11,1697,1,waiting,8
3,31,955.3,535.5,2125,-278,1847,1,waiting,8
3,32,943.4,537.3,1895,-165,1730,1,waiting,8
3,33,949.2,529.3,523,-279,244,1,waiting,8
3,33,945.7,528.6,1448,262,1710,2,waiting,8
3,33,958.3,521,149,1728,1877,3,targOff,8
3,34,943.2,540.3,1266,-33,1233,1,waiting,8
3,34,958.1,537.8,223,1256,1479,2,targOff,8
3,35,943.8,539.5,2057,-280,1777,1,waiting,8
3,35,957.6,532.1,161,1786,1947,2,targOff,8
3,36,944.4,535.2,591,-289,302,1,waiting,8
3,36,952.5,536.3,1460,320,1780,2,waiting,8
3,37,942.2,524.1,1479,-31,1448,1,waiting,8
3,38,939.3,529.4,1163,-13,1150,1,waiting,8
3,38,956.4,547.3,496,1166,1662,2,targOff,8
3,39,943,547.4,1877,-280,1597,1,waiting,8
3,40,954,544.4,2005,-279,1726,1,waiting,8
3,1,969.4,678.1,129,106,235,1,waiting,9
3,1,949,554.3,867,247,1114,2,waiting,9
3,2,948.4,535.8,563,-277,286,1,waiting,9
3,2,953.8,534.2,656,305,961,2,waiting,9
3,2,756.1,543.2,454,1009,1463,3,targOff,9
3,3,933.5,531.2,305,-284,21,1,waiting,9
3,3,953.1,531.3,1226,39,1265,2,waiting,9
3,3,771.2,532,459,1318,1777,3,targOff,9
3,4,936.6,541.4,1124,-63,1061,1,waiting,9
3,4,1072.9,551.8,266,1085,1351,2,dotOff,9
3,4,1127.7,553.7,387,1376,1763,3,targOff,9
3,5,943.6,550,1250,-281,969,1,waiting,9
3,5,778.2,548.6,441,1018,1459,2,targOff,9
3,6,950.7,547.2,1336,-43,1293,1,waiting,9
3,6,1138.7,553.1,461,1320,1781,2,targOff,9
3,7,945.5,547.8,1315,-282,1033,1,waiting,9
3,7,778,546.7,472,1059,1531,2,targOff,9
3,8,946.4,542,1411,-237,1174,1,waiting,9
3,8,1120.3,545.8,443,1203,1646,2,targOff,9
3,9,945.4,546,323,-278,45,1,waiting,9
3,9,954.4,544.6,1315,51,1366,2,waiting,9
3,9,762.2,550.6,502,1412,1914,3,targOff,9
3,10,966.1,532.4,331,-288,43,1,waiting,9
3,10,952.6,531.6,1069,50,1119,2,waiting,9
3,10,771.3,531.8,247,1153,1400,3,targOff,9
3,10,756.2,532,201,1430,1631,4,targOff,9
3,11,981.1,546.3,206,-127,79,1,waiting,9
3,11,950.8,539,1321,102,1423,2,waiting,9
3,11,1126.9,538.6,445,1452,1897,3,targOff,9
3,12,942.4,555.5,284,-283,1,1,waiting,9
3,12,952.5,550.3,808,20,828,2,waiting,9
3,12,931.9,551.8,454,846,1300,3,waiting,9
3,12,1115.1,543.3,472,1326,1798,4,targOff,9
3,13,957.4,541.3,1243,14,1257,1,waiting,9
3,13,774.5,545.7,457,1307,1764,2,targOff,9
3,14,942.1,548.3,1522,-275,1247,1,waiting,9
3,14,1124.3,549.3,443,1272,1715,2,targOff,9
3,15,943.8,556.1,1479,-63,1416,1,waiting,9
3,15,775.7,540,268,1460,1728,2,targOff,9
3,15,750.8,537.2,199,1748,1947,3,targOff,9
3,16,952.6,550.1,1505,-282,1223,1,waiting,9
3,16,1144.5,547.1,482,1249,1731,2,targOff,9
3,17,931.9,559.2,47,13,60,1,waiting,9
3,17,965.3,549.8,131,88,219,2,waiting,9
3,17,948.2,546.5,809,235,1044,3,waiting,9
3,17,1111.6,540.7,479,1069,1548,4,targOff,9
3,18,947.7,553,202,8,210,1,waiting,9
3,18,948.5,545.1,914,227,1141,2,waiting,9
3,18,771.2,550.1,461,1187,1648,3,targOff,9
3,19,936.4,544.7,1470,-281,1189,1,waiting,9
3,19,769.8,553.7,430,1233,1663,2,targOff,9
3,20,947.1,543.8,1172,-49,1123,1,waiting,9
3,20,1110.4,536.6,335,1146,1481,2,targOff,9
3,21,970.6,545,295,-283,12,1,waiting,9
3,21,948.4,540.8,1278,38,1316,2,waiting,9
3,21,775.2,539.8,472,1375,1847,3,targOff,9
3,22,957.7,543.4,204,-17,187,1,waiting,9
3,22,942,539.1,784,204,988,2,waiting,9
3,22,751.6,544.1,474,1036,1510,3,targOff,9
3,23,948.8,554.4,1615,-280,1335,1,waiting,9
3,23,1129,547.4,487,1360,1847,2,targOff,9
3,24,954.2,614,425,-290,135,1,waiting,9
3,24,957.9,584.9,716,197,913,2,waiting,9
3,25,954.3,524.6,351,-273,78,1,waiting,9
3,25,949.7,539.3,978,85,1063,2,waiting,9
3,25,1120.7,551,476,1088,1564,3,targOff,9
3,26,943.9,545.5,1349,-269,1080,1,waiting,9
3,26,1116.9,546.8,462,1103,1565,2,targOff,9
3,27,952,544,1465,-35,1430,1,waiting,9
3,27,1120.9,545.9,476,1456,1932,2,targOff,9
3,28,950.6,547.6,1065,-25,1040,1,waiting,9
3,28,776.3,546.6,487,1077,1564,2,targOff,9
3,29,949.2,547,1236,-67,1169,1,waiting,9
3,29,781.5,546.7,384,1197,1581,2,targOff,9
3,30,948.9,551.9,1306,-34,1272,1,waiting,9
3,30,1124.5,556.5,465,1299,1764,2,targOff,9
3,31,944.2,549.7,1366,-25,1341,1,waiting,9
3,31,1119.4,556.7,443,1369,1812,2,targOff,9
3,32,945.3,547.2,1321,-274,1047,1,waiting,9
3,32,779.9,540.1,464,1084,1548,2,targOff,9
3,33,940,548.8,812,-72,740,1,waiting,9
3,33,942.9,543.2,466,758,1224,2,waiting,9
3,33,1099.6,545.6,427,1250,1677,3,targOff,9
3,34,971.8,558.4,187,-177,10,1,waiting,9
3,34,948.1,553.9,1291,33,1324,2,waiting,9
3,34,1121.7,553.5,464,1351,1815,3,targOff,9
3,35,945.7,546.4,1574,-282,1292,1,waiting,9
3,35,1124.9,553.2,480,1317,1797,2,targOff,9
3,36,941.1,547.8,1540,-164,1376,1,waiting,9
3,36,1125.8,554.6,444,1404,1848,2,targOff,9
3,37,943.3,563.2,1304,-282,1022,1,waiting,9
3,37,1100.3,561.1,260,1048,1308,2,targOff,9
3,37,1136.9,559,129,1335,1464,3,targOff,9
3,38,952.5,532.1,433,-23,410,1,waiting,9
3,38,939.5,532.7,847,427,1274,2,waiting,9
3,38,778.2,536.8,314,1321,1635,3,targOff,9
3,38,764.1,530.6,154,1643,1797,4,targOff,9
3,39,951.2,541,1854,-40,1814,1,waiting,9
3,40,955.5,542.6,305,-272,33,1,waiting,9
3,40,948.2,538.3,1057,49,1106,2,waiting,9
3,40,775.4,542.5,463,1152,1615,3,targOff,9
3,1,942.5,539.5,364,179,543,1,waiting,10
3,1,941.8,544.9,494,587,1081,2,waiting,10
3,2,947.8,547.4,682,-281,401,1,waiting,10
3,2,951.3,552.6,1047,417,1464,2,waiting,10
3,3,947.6,542.4,1916,-283,1633,1,waiting,10
3,3,962,532.9,222,1659,1881,2,targOff,10
3,4,955.3,536.6,670,-288,382,1,waiting,10
3,4,951,540.6,1431,400,1831,2,waiting,10
3,5,942.5,541.8,1638,-280,1358,1,waiting,10
3,5,942.6,527.3,164,1379,1543,2,targOff,10
3,6,948.4,541.8,1924,-276,1648,1,waiting,10
3,7,952.2,536.9,1330,-17,1313,1,waiting,10
3,7,969.6,534.8,248,1332,1580,2,targOff,10
3,8,942.6,535.8,819,-271,548,1,waiting,10
3,8,948.3,534.4,880,567,1447,2,waiting,10
3,9,947.4,539.9,335,-279,56,1,waiting,10
3,9,944.7,542.8,1692,73,1765,2,waiting,10
3,10,944.7,538.2,1550,-270,1280,1,waiting,10
3,10,953,533,158,1307,1465,2,targOff,10
3,11,947.4,540.5,742,-282,460,1,waiting,10
3,11,937,537.7,328,479,807,2,waiting,10
3,11,947.5,544.6,1131,815,1946,3,waiting,10
3,12,942.1,538.1,1722,-282,1440,1,waiting,10
3,12,959.6,534.2,155,1459,1614,2,targOff,10
3,13,944.7,537.8,763,-286,477,1,waiting,10
3,13,939,535.7,969,495,1464,2,waiting,10
3,14,942.1,536.3,1883,-285,1598,1,waiting,10
3,15,949.9,537.7,1796,-38,1758,1,waiting,10
3,15,981.6,525.8,107,1770,1877,2,targOff,10
3,16,952.1,536.1,1796,-282,1514,1,waiting,10
3,17,951.2,535.6,2047,-250,1797,1,waiting,10
3,18,945.3,541.9,1527,-67,1460,1,waiting,10
3,19,943.4,539.9,2047,-283,1764,1,waiting,10
3,20,947.2,535.1,858,-278,580,1,waiting,10
3,20,952.5,543.6,1128,597,1725,2,waiting,10
3,20,920.2,538.2,140,1741,1881,3,targOff,10
3,21,934.3,536.3,328,-29,299,1,waiting,10
3,21,944.9,540.6,1558,306,1864,2,waiting,10
3,22,943.4,546.2,2201,-288,1913,1,waiting,10
3,23,946.8,550.1,1943,-283,1660,1,waiting,10
3,23,942.6,545.9,223,1674,1897,2,targOff,10
3,24,945.2,545.7,1165,-280,885,1,waiting,10
3,24,960.5,538.2,133,904,1037,2,waiting,10
3,24,940.5,540.6,573,1057,1630,3,dotOff,10
3,25,942.5,547.1,2148,-284,1864,1,waiting,10
3,26,947,547.9,2180,-283,1897,1,waiting,10
3,27,942.8,549.5,1063,-71,992,1,waiting,10
3,27,1101,549.7,255,1017,1272,2,dotOff,10
3,27,1120,558.1,95,1279,1374,3,targOff,10
3,27,963.5,545.6,207,1420,1627,4,targOff,10
3,28,958.9,552.3,286,-284,2,1,waiting,10
3,28,943.4,550.4,1558,22,1580,2,waiting,10
3,29,941.8,550.4,1397,4,1401,1,waiting,10
3,29,950.9,548.2,222,1421,1643,2,targOff,10
3,30,949,543.8,2162,-281,1881,1,waiting,10
3,31,949.7,541.2,2113,-283,1830,1,waiting,10
3,32,936,542.8,2040,-276,1764,1,waiting,10
3,33,941.2,571.3,1417,-279,1138,1,waiting,10
3,33,946.6,550.1,183,1148,1331,2,targOff,10
3,33,951.9,545.1,165,1349,1514,3,targOff,10
3,34,951,548,1874,-277,1597,1,waiting,10
3,35,943.8,545.9,1552,-88,1464,1,waiting,10
3,36,944.2,550.5,1469,-5,1464,1,waiting,10
3,37,935.5,545.6,61,-59,2,1,waiting,10
3,37,935.2,548.3,244,13,257,2,waiting,10
3,37,936.3,551.9,20,267,287,3,waiting,10
3,37,938.4,548.9,212,297,509,4,waiting,10
3,37,946.7,548.7,1394,554,1948,5,waiting,10
3,38,950.6,556.6,2030,-282,1748,1,waiting,10
3,39,946,551.9,1108,-58,1050,1,waiting,10
3,39,954.4,551.4,478,1069,1547,2,targOff,10
3,40,948.8,552.8,2013,-283,1730,1,waiting,10
3,1,974.9,553,320,-284,36,1,waiting,11
3,1,947.9,548.7,1055,65,1120,2,waiting,11
3,1,1113.6,546.7,439,1159,1598,3,targOff,11
3,2,932,544,1295,-81,1214,1,waiting,11
3,2,1113.4,545.1,508,1240,1748,2,targOff,11
3,3,921.6,547.1,152,-126,26,1,waiting,11
3,3,945.5,539.3,950,45,995,2,waiting,11
3,3,1125.9,538.3,475,1022,1497,3,targOff,11
3,4,944.6,543.1,1452,-270,1182,1,waiting,11
3,4,770.9,541.9,451,1229,1680,2,targOff,11
3,5,949.3,543.5,1211,-61,1150,1,waiting,11
3,5,778.1,550.9,497,1184,1681,2,targOff,11
3,6,941.1,538.2,557,-278,279,1,waiting,11
3,6,970.7,542.3,190,290,480,2,waiting,11
3,6,947.7,538.5,642,498,1140,3,waiting,11
3,6,1127.5,542.4,479,1165,1644,4,targOff,11
3,7,945.7,545.7,1290,-274,1016,1,waiting,11
3,7,924.6,545,246,1025,1271,2,waiting,11
3,7,1123.6,535.8,483,1299,1782,3,targOff,11
3,8,945.5,537.6,1183,-285,898,1,waiting,11
3,8,1104.9,539.5,275,922,1197,2,waiting,11
3,9,934.3,546.2,1216,-18,1198,1,waiting,11
3,9,753.9,543.8,411,1253,1664,2,targOff,11
3,10,939.8,552.8,1004,-278,726,1,waiting,11
3,10,958.1,550.7,233,745,978,2,waiting,11
3,10,769.9,557.2,456,1025,1481,3,targOff,11
3,11,937.5,552.6,1118,-4,1114,1,waiting,11
3,11,1134.5,556.7,458,1139,1597,2,targOff,11
3,12,944.2,553.1,1570,-284,1286,1,waiting,11
3,12,779.5,558,457,1310,1767,2,dotOff,11
3,12,862.4,547.7,104,1793,1897,3,targOff,11
3,13,958.8,550.9,153,-21,132,1,waiting,11
3,13,945.3,548.2,1127,151,1278,2,waiting,11
3,13,1121.5,547.1,493,1305,1798,3,targOff,11
3,14,942.6,550.1,1416,-191,1225,1,waiting,11
3,14,1127,559.2,460,1254,1714,2,targOff,11
3,15,943.3,549.9,1495,-272,1223,1,waiting,11
3,15,771.2,543.5,478,1270,1748,2,targOff,11
3,16,947.8,544.4,1582,-281,1301,1,waiting,11
3,16,1126.9,539.7,486,1328,1814,2,targOff,11
3,17,942,529.9,1029,-14,1015,1,waiting,11
3,17,781.7,530.3,451,1046,1497,2,targOff,11
3,18,941.3,532.3,1605,-272,1333,1,waiting,11
3,18,785.2,541,485,1379,1864,2,targOff,11
3,19,937.5,543.3,1664,-286,1378,1,waiting,11
3,19,1113.4,541.5,477,1404,1881,2,targOff,11
3,20,941.2,548.7,1366,16,1382,1,waiting,11
3,20,772.7,551.8,397,1426,1823,2,targOff,11
3,20,968.7,537.2,48,1850,1898,3,targOff,11
3,21,944.8,555.8,1305,-286,1019,1,waiting,11
3,21,767.4,551.4,486,1061,1547,2,targOff,11
3,22,939.1,558.5,1397,-18,1379,1,waiting,11
3,22,771.7,547.5,490,1424,1914,2,targOff,11
3,23,914.9,570.1,204,-172,32,1,waiting,11
3,23,942.2,562.6,1071,54,1125,2,waiting,11
3,23,769.5,554.5,487,1173,1660,3,targOff,11
3,24,944.3,546.1,1310,-12,1298,1,waiting,11
3,24,784.7,544.9,502,1328,1830,2,targOff,11
3,25,939.3,554.5,1289,-19,1270,1,waiting,11
3,25,1122.2,548.6,482,1298,1780,2,targOff,11
3,26,945.2,551.1,1664,-286,1378,1,waiting,11
3,26,782,539.9,473,1424,1897,2,targOff,11
3,27,942.2,545.2,1356,-284,1072,1,waiting,11
3,27,820.3,545.1,193,1109,1302,2,targOff,11
3,27,769.1,546,214,1334,1548,3,targOff,11
3,28,933,622.2,113,-113,0,1,waiting,11
3,29,943.8,550.6,1037,12,1049,1,waiting,11
3,29,1132.1,555,506,1075,1581,2,targOff,11
3,30,932,629.7,433,-282,151,1,waiting,11
3,30,936.8,655.8,559,205,764,2,waiting,11
3,31,994.7,562.4,271,-271,0,1,waiting,11
3,31,944.1,541.7,209,41,250,2,waiting,11
3,31,934.5,548,251,258,509,3,waiting,11
3,31,935.2,556.9,78,516,594,4,waiting,11
3,31,771.5,547.4,226,639,865,5,waiting,11
3,32,955.7,493,146,11,157,1,waiting,11
3,32,952.7,484.5,125,351,476,2,waiting,11
3,32,952.7,492.2,160,586,746,3,waiting,11
3,32,947.4,514.8,251,765,1016,4,waiting,11
3,32,947.2,499,42,1047,1089,5,dotOff,11
3,32,766.6,515.7,79,1134,1213,6,targOff,11
3,32,769.6,508.8,212,1225,1437,7,targOff,11
3,32,772.5,488.7,57,1474,1531,8,targOff,11
3,32,769,490.1,44,1570,1614,9,targOff,11
3,33,943.4,546.2,1250,-8,1242,1,waiting,11
3,33,784.9,539.4,431,1300,1731,2,targOff,11
3,34,952.6,540.4,1010,-35,975,1,waiting,11
3,34,1124.2,535.9,561,1015,1576,2,targVis,11
3,35,939.2,542.5,1576,-285,1291,1,waiting,11
3,35,1119.2,544.5,450,1314,1764,2,targOff,11
3,36,939.1,546.8,852,-42,810,1,waiting,11
3,36,774,549.5,239,859,1098,2,waiting,11
3,37,942.9,545.3,570,-281,289,1,waiting,11
3,37,948.1,547.1,897,305,1202,2,waiting,11
3,37,1094.6,547.5,434,1227,1661,3,targOff,11
3,38,980.2,560.4,181,-181,0,1,waiting,11
3,38,944.8,549,1300,23,1323,2,waiting,11
3,38,776.4,542.9,462,1369,1831,3,targOff,11
3,39,950.9,537.6,230,16,246,1,waiting,11
3,39,940.1,542.3,860,263,1123,2,waiting,11
3,39,1123,543.5,476,1155,1631,3,targOff,11
3,40,943.1,547.2,313,-276,37,1,waiting,11
3,40,940.1,541,1359,44,1403,2,waiting,11
3,40,1120.5,554.7,467,1430,1897,3,targOff,11
3,1,906.4,536.3,290,-276,14,1,waiting,12
3,1,949.7,538.3,1504,34,1538,2,waiting,12
3,1,950.5,534.9,182,1549,1731,3,targOff,12
3,2,948.8,537.8,1672,-94,1578,1,waiting,12
3,2,954.3,529.4,167,1597,1764,2,targOff,12
3,3,944.5,529,1990,-276,1714,1,waiting,12
3,4,946.4,533.4,2207,-281,1926,1,waiting,12
3,5,942.7,539.8,1965,-34,1931,1,waiting,12
3,6,948.7,535.8,1857,-281,1576,1,waiting,12
3,7,944.4,545.1,307,-272,35,1,waiting,12
3,7,943.6,548.5,1791,57,1848,2,waiting,12
3,8,950.4,548.8,1960,-279,1681,1,waiting,12
3,9,949.4,554.2,2037,-273,1764,1,waiting,12
3,10,948.9,541.6,1527,3,1530,1,waiting,12
3,11,949.4,531.4,1633,-284,1349,1,waiting,12
3,11,958,530.7,174,1356,1530,2,targOff,12
3,12,944.9,537.3,830,-272,558,1,waiting,12
3,12,983.6,527.1,153,573,726,2,waiting,12
3,12,952.1,536,826,754,1580,3,waiting,12
3,13,950,546,1751,-120,1631,1,waiting,12
3,14,943.1,553.9,1466,-73,1393,1,waiting,12
3,14,955.4,553.9,157,1408,1565,2,targOff,12
3,15,942.3,549.7,2124,-276,1848,1,waiting,12
3,16,953.9,550.7,370,-289,81,1,waiting,12
3,16,938.7,552.7,220,88,308,2,waiting,12
3,16,977.2,550.7,212,320,532,3,waiting,12
3,16,950,552.9,1137,551,1688,4,waiting,12
3,16,1062.9,551.6,104,1708,1812,5,targOff,12
3,17,947.5,552.5,1759,-278,1481,1,waiting,12
3,18,948.1,557,1728,-14,1714,1,waiting,12
3,19,948.9,543.5,1979,-281,1698,1,waiting,12
3,20,949.1,539.5,1869,-278,1591,1,waiting,12
3,20,925.9,535.8,164,1600,1764,2,targOff,12
3,21,948.5,540.7,2073,-276,1797,1,waiting,12
3,22,948.5,543.7,1535,-282,1253,1,waiting,12
3,22,941.3,546.6,639,1270,1909,2,dotOff,12
3,23,934.1,549.6,1095,-68,1027,1,waiting,12
3,23,932.9,557.2,110,1039,1149,2,targOff,12
3,23,936.7,545.4,65,1161,1226,3,targOff,12
3,23,935.8,557.6,44,1245,1289,4,targOff,12
3,23,940.2,522.5,49,1303,1352,5,targOff,12
3,23,936,537.2,71,1376,1447,6,targOff,12
3,24,957.5,556.8,1759,-279,1480,1,waiting,12
3,25,945.3,539.8,1696,2,1698,1,waiting,12
3,26,953.2,533.8,1772,-279,1493,1,waiting,12
3,27,933.7,535.2,1864,-283,1581,1,waiting,12
3,28,946.8,545.7,1996,-281,1715,1,waiting,12
3,29,946.2,540.4,2078,-284,1794,1,waiting,12
3,30,948.1,556.9,1950,-279,1671,1,waiting,12
3,30,955.9,550.2,110,1688,1798,2,targOff,12
3,31,962.6,539.3,535,-278,257,1,waiting,12
3,31,949.6,549.4,1633,281,1914,2,waiting,12
3,32,944.7,549.5,1101,-6,1095,1,waiting,12
3,32,947.3,549.7,536,1111,1647,2,targVis,12
3,33,954,538,1689,-13,1676,1,waiting,12
3,34,949.6,541.4,304,-44,260,1,waiting,12
3,34,942.2,547.7,1649,279,1928,2,waiting,12
3,35,951.8,545.7,1791,-277,1514,1,waiting,12
3,36,943,540.3,747,-281,466,1,waiting,12
3,36,953.1,551.7,1042,487,1529,2,waiting,12
3,37,946.4,544.1,2026,-279,1747,1,waiting,12
3,38,933.6,539.9,289,-273,16,1,waiting,12
3,38,941.7,534.5,1630,34,1664,2,waiting,12
3,39,940.8,562.7,1729,1,1730,1,waiting,12
3,39,890.7,550.2,52,1745,1797,2,targOff,12
3,40,945.8,552.7,2068,-237,1831,1,waiting,12
3,1,986.3,543.6,326,-281,45,1,waiting,13
3,1,968.5,540.2,1219,57,1276,2,waiting,13
3,1,1141.8,535.5,489,1303,1792,3,targOff,13
3,2,965.4,522.1,373,-283,90,1,waiting,13
3,2,960.2,536.3,981,99,1080,2,waiting,13
3,2,784.1,533.4,463,1116,1579,3,targOff,13
3,3,954.1,527.5,1463,-271,1192,1,waiting,13
3,3,1143.6,536.1,459,1222,1681,2,targOff,13
3,4,950.4,538.2,1618,-275,1343,1,waiting,13
3,4,1144.4,544.2,456,1375,1831,2,targOff,13
3,5,958.2,545.9,1517,-281,1236,1,waiting,13
3,5,1150,545.4,468,1262,1730,2,targOff,13
3,6,949.8,543.7,1316,-284,1032,1,waiting,13
3,6,1105.7,547.3,406,1058,1464,2,targOff,13
3,7,955.1,537.1,1298,-287,1011,1,waiting,13
3,7,780.8,549.4,471,1044,1515,2,targOff,13
3,8,947.6,542.2,1477,-76,1401,1,waiting,13
3,8,1145.6,540.8,450,1430,1880,2,targOff,13
3,9,960,528.4,1427,-273,1154,1,waiting,13
3,9,1135.6,533.8,448,1182,1630,2,targOff,13
3,10,952.6,544.6,1392,-283,1109,1,waiting,13
3,10,1146.3,549.3,480,1134,1614,2,targOff,13
3,11,956.3,540.9,538,-47,491,1,waiting,13
3,11,953.4,546.6,725,530,1255,2,waiting,13
3,11,775.8,552.3,456,1291,1747,3,targOff,13
3,12,954.4,542.6,1605,-278,1327,1,waiting,13
3,12,1150.6,540.4,485,1362,1847,2,targOff,13
3,13,953,542.2,1494,-84,1410,1,waiting,13
3,13,777.2,546.1,470,1444,1914,2,targOff,13
3,14,955.8,543.2,1307,-72,1235,1,waiting,13
3,14,1123.9,553.1,452,1262,1714,2,targOff,13
3,15,956.4,546,1071,-80,991,1,waiting,13
3,15,1156.5,561.2,444,1020,1464,2,targOff,13
3,16,955.6,547.3,1412,-222,1190,1,waiting,13
3,16,1112.5,550.8,430,1218,1648,2,targOff,13
3,17,1032.5,559.6,299,-278,21,1,waiting,13
3,17,960.7,553.1,1042,57,1099,2,waiting,13
3,17,1141.3,567.4,487,1127,1614,3,targOff,13
3,18,969.3,504,64,-36,28,1,waiting,13
3,18,946,552.3,99,81,180,2,waiting,13
3,18,955.1,555.5,932,315,1247,3,waiting,13
3,19,955.4,518,76,37,113,1,waiting,13
3,19,960.3,498.8,107,123,230,2,waiting,13
3,19,960,510.3,296,241,537,3,waiting,13
3,19,953,535.1,822,601,1423,4,waiting,13
3,19,1144.7,530.6,463,1451,1914,5,targOff,13
3,20,960.4,552.8,291,-283,8,1,waiting,13
3,20,957.5,559.1,66,31,97,2,waiting,13
3,20,954.6,520.8,761,104,865,3,waiting,13
3,20,957.8,515.2,267,949,1216,4,waiting,13
3,20,957.9,522.6,37,1227,1264,5,waiting,13
3,20,957.5,523.9,124,1276,1400,6,dotOff,13
3,20,955.8,519.1,23,1411,1434,7,targOff,13
3,20,1135,520.5,199,1460,1659,8,targOff,13
3,20,1140.3,520.5,247,1667,1914,9,targOff,13
3,21,956.2,504.3,1400,-280,1120,1,waiting,13
3,21,789.5,489.8,453,1157,1610,2,targOff,13
3,22,956,530.5,685,-63,622,1,waiting,13
3,22,953.5,537.6,785,633,1418,2,waiting,13
3,22,792.1,534,460,1454,1914,3,targOff,13
3,23,960.8,515.3,54,-29,25,1,waiting,13
3,23,960.9,524.1,519,50,569,2,waiting,13
3,23,957.7,516.3,203,604,807,3,waiting,13
3,23,957.5,518.1,489,816,1305,4,waiting,13
3,23,1086.5,517.7,193,1331,1524,5,targOff,13
3,23,1155.4,512.1,196,1548,1744,6,targOff,13
3,24,958.5,532.9,1180,-34,1146,1,waiting,13
3,24,1117.5,519.1,253,1181,1434,2,targOff,13
3,24,1148.6,515.6,106,1457,1563,3,targOff,13
3,25,949,504.6,304,-287,17,1,waiting,13
3,25,956.9,541.2,1166,24,1190,2,waiting,13
3,25,1148.7,526.2,282,1215,1497,3,targOff,13
3,26,954.7,537,1271,-283,988,1,waiting,13
3,26,1145.3,517,465,1015,1480,2,targOff,13
3,27,959.3,506.5,1263,-283,980,1,waiting,13
3,27,789.8,506.9,427,1012,1439,2,targOff,13
3,27,781.5,524,44,1449,1493,3,targOff,13
3,28,946.3,503.3,236,-206,30,1,waiting,13
3,28,955.7,516,55,113,168,2,waiting,13
3,28,955.1,522.9,25,179,204,3,waiting,13
3,28,955.5,532.5,102,261,363,4,waiting,13
3,28,945.7,525.6,497,380,877,5,waiting,13
3,28,946.9,495.5,58,939,997,6,waiting,13
3,28,943.9,524.8,68,1031,1099,7,dotOff,13
3,28,945.3,531.7,39,1116,1155,8,targVis,13
3,28,793.1,548.1,298,1200,1498,9,targOff,13
3,29,958.3,563.8,783,-213,570,1,waiting,13
3,29,947.9,562.6,612,581,1193,2,waiting,13
3,29,785.9,561.9,410,1221,1631,3,targOff,13
3,30,953.1,515.3,148,-24,124,1,waiting,13
3,30,953.5,531.5,39,140,179,2,waiting,13
3,30,950.6,559.2,28,196,224,3,waiting,13
3,30,953.6,537.7,36,241,277,4,waiting,13
3,30,950.6,539.9,128,288,416,5,waiting,13
3,30,949.7,545.2,91,465,556,6,waiting,13
3,30,949.4,554.2,46,564,610,7,waiting,13
3,30,952.2,559.5,357,687,1044,8,waiting,13
3,30,949.7,570.3,35,1055,1090,9,waiting,13
3,30,952.8,555.4,66,1102,1168,10,waiting,13
3,30,953.3,562.1,107,1188,1295,11,dotOff,13
3,30,1118.3,544.6,97,1322,1419,12,targOff,13
3,30,1117.1,550.1,67,1429,1496,13,targOff,13
3,30,1118.5,554.8,25,1508,1533,14,targOff,13
3,30,1119.7,544.7,109,1548,1657,15,targOff,13
3,30,1151.1,538.4,66,1679,1745,16,targOff,13
3,30,1152.2,522.1,52,1761,1813,17,targOff,13
3,31,931.8,549.9,174,7,181,1,waiting,13
3,31,960.1,553.3,1382,189,1571,2,waiting,13
3,31,788.4,550.7,204,1605,1809,3,targOff,13
3,32,962.5,502.7,1304,-281,1023,1,waiting,13
3,32,1135.1,507.9,348,1050,1398,2,targOff,13
3,32,975.9,490.4,73,1424,1497,3,targOff,13
3,33,955.5,553.9,972,16,988,1,waiting,13
3,33,767.5,548.9,460,1037,1497,2,targOff,13
3,34,948.9,547.4,1301,-279,1022,1,waiting,13
3,34,1128,549,465,1049,1514,2,targOff,13
3,35,951.7,540.4,1271,-279,992,1,waiting,13
3,35,1123.8,548.8,430,1017,1447,2,targOff,13
3,36,957.7,543.6,1725,-277,1448,1,waiting,13
3,36,1127.8,536.1,457,1473,1930,2,targOff,13
3,37,955.8,538.8,1558,-275,1283,1,waiting,13
3,37,772.7,541.4,467,1331,1798,2,targOff,13
3,38,969.6,529.3,149,-147,2,1,waiting,13
3,38,950.3,544.4,1141,31,1172,2,waiting,13
3,38,778.1,549.7,492,1206,1698,3,targOff,13
3,39,964.3,542.5,666,-280,386,1,waiting,13
3,39,955.2,535.6,631,395,1026,2,waiting,13
3,39,767.6,548.4,455,1071,1526,3,targOff,13
3,40,956.1,541.5,1388,-3,1385,1,waiting,13
3,40,1139.3,543,453,1411,1864,2,targOff,13
3,1,1006.7,551.3,272,-270,2,1,waiting,14
3,1,962,541.7,1741,23,1764,2,waiting,14
3,2,951.9,542.3,1015,-272,743,1,waiting,14
3,2,959,544.7,1014,766,1780,2,waiting,14
3,3,956.8,546.8,289,-17,272,1,waiting,14
3,3,961.4,544.5,1123,295,1418,2,waiting,14
3,3,960.9,548,222,1439,1661,3,targOff,14
3,4,951.4,550.7,1804,-280,1524,1,waiting,14
3,4,954.9,550.9,232,1549,1781,2,targOff,14
3,5,958.7,551.1,660,-49,611,1,waiting,14
3,5,953.7,544.3,198,620,818,2,waiting,14
3,5,964.2,574,181,912,1093,3,waiting,14
3,6,932.2,557.4,297,-280,17,1,waiting,14
3,6,949.7,542.5,336,35,371,2,waiting,14
3,6,962.6,548.8,1510,388,1898,3,waiting,14
3,7,945.7,546,364,-279,85,1,waiting,14
3,7,967.5,545.8,160,104,264,2,waiting,14
3,7,956.2,551,1551,280,1831,3,waiting,14
3,8,956.7,547,1441,6,1447,1,waiting,14
3,9,955,553.8,1593,-44,1549,1,waiting,14
3,9,952.7,551.3,208,1570,1778,2,targOff,14
3,10,958.9,548.1,270,-6,264,1,waiting,14
3,10,975.8,567.3,178,355,533,2,waiting,14
3,10,956.3,557.1,479,552,1031,3,waiting,14
3,11,976.1,553.4,125,-4,121,1,waiting,14
3,11,957.8,555.4,1371,143,1514,2,waiting,14
3,12,942.5,555.9,265,-23,242,1,waiting,14
3,12,948.2,551,1389,258,1647,2,waiting,14
3,13,956.3,553.6,1707,-177,1530,1,waiting,14
3,14,953.9,552.8,1929,-81,1848,1,waiting,14
3,15,957.4,552.8,2021,-274,1747,1,waiting,14
3,16,960.5,545.8,1795,-131,1664,1,waiting,14
3,17,958.4,540.1,2103,-206,1897,1,waiting,14
3,18,962.8,544.7,503,-284,219,1,waiting,14
3,18,952.7,547.9,1303,228,1531,2,waiting,14
3,19,961.6,556.3,1942,-11,1931,1,waiting,14
3,20,953.5,544.2,869,-273,596,1,waiting,14
3,20,954.7,545,1301,613,1914,2,waiting,14
3,21,956.6,539.4,2033,-119,1914,1,waiting,14
3,22,964.2,508,278,-138,140,1,waiting,14
3,22,961.7,519.1,307,171,478,2,waiting,14
3,22,966.6,519,65,486,551,3,waiting,14
3,22,962.9,537.5,33,570,603,4,waiting,14
3,22,964.2,535.9,175,614,789,5,waiting,14
3,22,963.9,550.9,958,805,1763,6,waiting,14
3,23,956.4,549.1,1996,-269,1727,1,waiting,14
3,23,962.4,532.2,162,1735,1897,2,targOff,14
3,24,956.4,538,1708,-25,1683,1,waiting,14
3,24,959.5,531.1,146,1702,1848,2,targOff,14
3,25,949.5,539.5,1828,-286,1542,1,waiting,14
3,26,947.5,533.9,96,1,97,1,waiting,14
3,26,948.6,524.1,50,104,154,2,waiting,14
3,26,953.6,532.9,450,180,630,3,waiting,14
3,26,960.6,532.7,26,638,664,4,waiting,14
3,26,958.9,544.4,86,680,766,5,waiting,14
3,26,948.9,549.9,177,785,962,6,waiting,14
3,26,956,519.7,64,987,1051,7,waiting,14
3,26,949.7,544.7,768,1063,1831,8,waiting,14
3,27,953.6,517.5,1123,-277,846,1,waiting,14
3,27,949.3,547.5,960,870,1830,2,waiting,14
3,28,951.7,536.2,72,10,82,1,waiting,14
3,28,952.7,539.8,60,95,155,2,waiting,14
3,28,957.1,543.7,1764,167,1931,3,waiting,14
3,29,949.8,526.1,70,41,111,1,waiting,14
3,29,947.9,538.7,41,124,165,2,waiting,14
3,29,958.5,519.9,88,175,263,3,waiting,14
3,29,960.1,511.8,113,282,395,4,waiting,14
3,29,950.7,553.9,960,449,1409,5,waiting,14
3,29,937.9,554.5,130,1429,1559,6,targOff,14
3,30,954,547.5,815,-28,787,1,waiting,14
3,30,951.9,553.1,25,837,862,2,waiting,14
3,30,955.6,543.6,139,906,1045,3,waiting,14
3,30,955,548.4,660,1057,1717,4,waiting,14
3,30,949,549.8,112,1728,1840,5,targOff,14
3,30,949.6,549.1,46,1851,1897,6,targOff,14
3,31,943.3,545.6,916,-155,761,1,waiting,14
3,31,949.1,543.8,47,772,819,2,waiting,14
3,31,949.7,522.7,33,831,864,3,waiting,14
3,31,946.3,542.1,68,874,942,4,waiting,14
3,31,946.8,543.5,34,953,987,5,waiting,14
3,31,946.8,539.1,31,1039,1070,6,dotOff,14
3,31,952,515.3,37,1080,1117,7,dotOff,14
3,31,945.2,551.8,161,1129,1290,8,dotOff,14
3,31,928.4,530.1,32,1369,1401,9,targOff,14
3,31,930.4,527.3,47,1454,1501,10,targOff,14
3,31,928.7,532.3,40,1526,1566,11,targOff,14
3,31,933.1,510.5,66,1631,1697,12,targOff,14
3,32,950.1,453,227,-64,163,1,waiting,14
3,32,953.3,553.9,775,384,1159,2,waiting,14
3,33,969.8,478.5,300,-279,21,1,waiting,14
3,33,964.6,482.8,1421,39,1460,2,waiting,14
3,34,956.6,552.9,2044,-165,1879,1,waiting,14
3,35,958.6,543.6,1222,-279,943,1,waiting,14
3,35,950.8,549.3,717,964,1681,2,waiting,14
3,36,960.7,543.9,1765,-51,1714,1,waiting,14
3,37,952.3,556.7,300,-277,23,1,waiting,14
3,37,962.6,550.1,1498,31,1529,2,waiting,14
3,38,956.5,548.3,2193,-279,1914,1,waiting,14
3,39,958.6,542.8,2209,-278,1931,1,waiting,14
3,40,963.9,537.5,2038,-274,1764,1,waiting,14
3,1,973.8,499,202,31,233,1,waiting,15
3,1,953.6,487.1,83,251,334,2,waiting,15
3,1,952.2,489.7,59,341,400,3,waiting,15
3,1,965.8,496.7,265,410,675,4,waiting,15
3,1,966.5,492.7,59,693,752,5,waiting,15
3,1,963.7,493.1,109,759,868,6,waiting,15
3,1,962.7,538.7,132,1001,1133,7,waiting,15
3,1,964.5,502.5,69,1149,1218,8,waiting,15
3,1,960.4,524.3,56,1257,1313,9,dotOff,15
3,1,779.4,503,34,1361,1395,10,targOff,15
3,1,790.7,483.6,424,1407,1831,11,targOff,15
3,2,949.9,542.4,1404,-283,1121,1,waiting,15
3,2,771.7,541,416,1165,1581,2,targOff,15
3,3,949.8,539,512,-282,230,1,waiting,15
3,3,958.8,543,1062,250,1312,2,waiting,15
3,3,1121.2,555.6,443,1337,1780,3,targOff,15
3,4,959.1,539.5,1532,-279,1253,1,waiting,15
3,4,1139.9,547.4,471,1277,1748,2,targOff,15
3,5,962.3,540.1,568,-25,543,1,waiting,15
3,5,953.2,538,669,550,1219,2,waiting,15
3,5,1120.9,540.5,418,1247,1665,3,targOff,15
3,6,954,536.3,1505,-270,1235,1,waiting,15
3,6,798.3,535.4,418,1262,1680,2,targOff,15
3,7,955.2,529.7,318,-15,303,1,waiting,15
3,7,954.7,536.1,848,321,1169,2,waiting,15
3,7,1124.5,544,453,1195,1648,3,targOff,15
3,8,948.5,493.9,66,-52,14,1,waiting,15
3,8,950.8,523,65,31,96,2,waiting,15
3,8,956.1,533.8,160,116,276,3,waiting,15
3,8,959.6,543.2,768,413,1181,4,waiting,15
3,9,998.4,541.3,200,-192,8,1,waiting,15
3,9,955.2,543.9,1367,32,1399,2,waiting,15
3,9,771.7,542.6,503,1430,1933,3,targVis,15
3,10,953.5,540.2,1663,-273,1390,1,waiting,15
3,10,1104.8,538.8,249,1431,1680,2,targOff,15
3,11,927.1,550.6,291,-279,12,1,waiting,15
3,11,962.1,540.8,1082,29,1111,2,waiting,15
3,11,1117.9,545.1,478,1136,1614,3,targOff,15
3,12,952.1,539.7,1383,-291,1092,1,waiting,15
3,12,1119.8,538.6,448,1116,1564,2,targOff,15
3,13,955,544.9,1373,-278,1095,1,waiting,15
3,13,779.3,543.9,469,1128,1597,2,targOff,15
3,14,956.4,512.8,102,8,110,1,waiting,15
3,14,954.7,533.6,55,121,176,2,waiting,15
3,14,957.1,543.1,996,184,1180,3,waiting,15
3,14,756.6,540.2,473,1225,1698,4,targOff,15
3,15,955.5,537.5,1086,-5,1081,1,waiting,15
3,15,783.4,537.3,471,1127,1598,2,targOff,15
3,16,959.9,536.2,1247,-55,1192,1,waiting,15
3,16,1114.8,538.1,465,1216,1681,2,targOff,15
3,17,961.1,544.8,1279,-195,1084,1,waiting,15
3,17,782.9,543.8,497,1117,1614,2,targOff,15
3,18,955.2,549.8,1218,-9,1209,1,waiting,15
3,18,779,533.9,477,1254,1731,2,targOff,15
3,19,951.3,549.4,1616,-277,1339,1,waiting,15
3,19,778.2,548.3,481,1367,1848,2,targOff,15
3,20,947.9,518.2,154,-4,150,1,waiting,15
3,20,950.4,513.5,616,160,776,2,waiting,15
3,20,954.5,503.4,143,794,937,3,waiting,15
3,20,951.4,536.2,47,1002,1049,4,targVis,15
3,20,766.4,541.4,448,1082,1530,5,targOff,15
3,21,953.2,534.1,1506,-77,1429,1,waiting,15
3,21,772.3,533.8,467,1464,1931,2,targOff,15
3,22,959.6,541.8,147,-125,22,1,waiting,15
3,22,958.4,528.3,1109,38,1147,2,waiting,15
3,22,1121.5,545,458,1173,1631,3,targOff,15
3,23,948.8,530.8,69,-13,56,1,waiting,15
3,23,953,546.1,936,132,1068,2,waiting,15
3,23,764.5,540.8,485,1112,1597,3,targOff,15
3,24,939,559.1,249,-64,185,1,waiting,15
3,24,956.1,547.3,873,192,1065,2,waiting,15
3,24,784.3,550.4,278,1099,1377,3,targOff,15
3,24,761.1,548.5,203,1395,1598,4,targOff,15
3,25,950.8,545.9,1149,-16,1133,1,waiting,15
3,25,1129.1,544.7,506,1158,1664,2,targOff,15
3,26,948.5,541.2,1435,-276,1159,1,waiting,15
3,26,772.6,546.5,460,1205,1665,2,targOff,15
3,27,951.2,534,1286,-73,1213,1,waiting,15
3,27,790.2,534.2,487,1243,1730,2,targOff,15
3,28,953.8,559.1,1420,-24,1396,1,waiting,15
3,28,785.5,552.5,504,1427,1931,2,targOff,15
3,29,958.7,539.1,200,-31,169,1,waiting,15
3,29,952.5,549.2,933,187,1120,2,waiting,15
3,29,1134.7,548.4,480,1150,1630,3,targOff,15
3,30,935.3,550.3,189,-172,17,1,waiting,15
3,30,950.4,543.1,1302,36,1338,2,waiting,15
3,30,1135.1,543.2,518,1363,1881,3,targVis,15
3,31,955.4,536.1,1550,-279,1271,1,waiting,15
3,31,1124.5,541.5,458,1306,1764,2,targOff,15
3,32,962.5,538.7,1213,-60,1153,1,waiting,15
3,32,1130.2,537.4,486,1178,1664,2,targOff,15
3,33,956.4,539.4,1552,-271,1281,1,waiting,15
3,33,785.9,532.7,487,1310,1797,2,targOff,15
3,34,962.6,525.1,630,-29,601,1,waiting,15
3,34,955.7,530,444,621,1065,2,waiting,15
3,34,781.9,537.4,424,1090,1514,3,targOff,15
3,35,953.5,536.5,1659,-278,1381,1,waiting,15
3,35,1120.8,534.7,476,1405,1881,2,targOff,15
3,36,946.5,544.5,1675,-286,1389,1,waiting,15
3,36,1136.8,549.8,493,1417,1910,2,targOff,15
3,37,955.1,560.8,1489,-85,1404,1,waiting,15
3,37,772.4,548.3,491,1457,1948,2,targOff,15
3,38,951.6,556.5,1049,-25,1024,1,waiting,15
3,38,1103.7,550,322,1048,1370,2,targOff,15
3,39,946,558.8,1131,4,1135,1,waiting,15
3,39,777,560,453,1178,1631,2,targOff,15
3,40,956.1,550.3,1212,-41,1171,1,waiting,15
3,40,1139.7,555,467,1197,1664,2,targOff,15
3,1,947.3,526.1,410,20,430,1,waiting,16
3,1,950.3,535.6,1380,448,1828,2,waiting,16
3,2,947.4,545.9,259,-26,233,1,waiting,16
3,2,958.2,547,1641,240,1881,2,waiting,16
3,3,956,534.9,1896,-282,1614,1,waiting,16
3,4,949.3,548.9,286,-24,262,1,waiting,16
3,4,947.7,543.9,1377,270,1647,2,waiting,16
3,5,943.9,554,1868,-125,1743,1,waiting,16
3,6,954.5,550,2124,-278,1846,1,waiting,16
3,7,944,555.5,603,177,780,1,waiting,16
3,8,954.5,540.1,2092,-278,1814,1,waiting,16
3,9,950.6,540.9,1639,-240,1399,1,waiting,16
3,9,956.2,542.7,179,1418,1597,2,targOff,16
3,10,963.1,557.4,237,-43,194,1,waiting,16
3,10,949.3,551.2,1594,202,1796,2,waiting,16
3,11,946.6,548.5,1637,-156,1481,1,waiting,16
3,12,959.2,550.1,313,-285,28,1,waiting,16
3,12,946.6,546.1,1882,49,1931,2,waiting,16
3,13,951.1,546.1,1989,-275,1714,1,waiting,16
3,14,950.3,556.3,2011,-278,1733,1,waiting,16
3,14,1003.1,552.2,66,1743,1809,2,targOff,16
3,15,947.4,551.3,956,-279,677,1,waiting,16
3,15,945.8,545.8,536,695,1231,2,waiting,16
3,15,1136.7,556,238,1259,1497,3,targOff,16
3,16,896.8,538.7,286,-273,13,1,waiting,16
3,16,950.8,542.4,1635,29,1664,2,waiting,16
3,17,962.2,539.8,569,-31,538,1,waiting,16
3,17,952.5,540,1282,546,1828,2,waiting,16
3,18,955,534.1,1510,-29,1481,1,waiting,16
3,19,954.8,544.2,1771,-278,1493,1,waiting,16
3,20,953.2,537.1,1847,-230,1617,1,waiting,16
3,20,991,526,132,1630,1762,2,targOff,16
3,21,958.4,536.7,1548,-72,1476,1,waiting,16
3,22,948.6,545.6,1900,-23,1877,1,waiting,16
3,23,948.6,540.5,1990,-279,1711,1,waiting,16
3,24,962.1,539.6,2199,-286,1913,1,waiting,16
3,25,952.2,543.9,1739,-275,1464,1,waiting,16
3,26,948.8,548.4,1859,-283,1576,1,waiting,16
3,27,946,542.5,1816,-285,1531,1,waiting,16
3,28,942.2,543.4,865,-284,581,1,waiting,16
3,28,945.9,541.7,1057,602,1659,2,waiting,16
3,29,954.7,540.5,1719,-9,1710,1,waiting,16
3,29,1005.2,537.9,74,1723,1797,2,targOff,16
3,30,951.5,544.1,1606,-109,1497,1,waiting,16
3,31,948,546.6,1998,-66,1932,1,waiting,16
3,32,961,537.6,2157,-279,1878,1,waiting,16
3,33,962.3,536.4,344,-279,65,1,waiting,16
3,33,958.2,542.2,1861,82,1943,2,waiting,16
3,34,957.2,551.4,1993,-278,1715,1,waiting,16
3,34,943.8,542.9,153,1723,1876,2,targOff,16
3,35,954.8,535.6,1830,-282,1548,1,waiting,16
3,36,956.7,556,1873,-26,1847,1,waiting,16
3,37,949.7,561,1885,-271,1614,1,waiting,16
3,38,933.5,536,272,-221,51,1,waiting,16
3,38,945,548.3,1618,59,1677,2,waiting,16
3,39,948.6,550.1,1726,-281,1445,1,waiting,16
3,39,1034.8,548.5,177,1470,1647,2,targOff,16
3,40,940.2,552.2,1755,-290,1465,1,waiting,16
3,40,932.1,541.9,156,1474,1630,2,targOff,16
3,1,951.5,549.8,1443,2,1445,1,waiting,17
3,1,780.1,549.5,454,1477,1931,2,targOff,17
3,2,957.4,540.6,1320,-89,1231,1,waiting,17
3,2,1110.4,544.9,476,1254,1730,2,targOff,17
3,3,945.3,543.5,1695,-281,1414,1,waiting,17
3,3,768.7,547,464,1445,1909,2,targOff,17
3,4,955.7,554.2,1214,-56,1158,1,waiting,17
3,4,780.4,548.9,489,1191,1680,2,targOff,17
3,5,947.2,547.6,657,-27,630,1,waiting,17
3,5,1097.9,554.5,191,654,845,2,waiting,17
3,5,955.7,551,480,872,1352,3,waiting,17
3,5,1134.9,549.9,378,1386,1764,4,targOff,17
3,6,940.6,542.4,1213,-3,1210,1,waiting,17
3,6,967.7,533.8,191,1218,1409,2,dotOff,17
3,6,766.8,537.2,442,1456,1898,3,targOff,17
3,7,948.5,533.8,1493,-275,1218,1,waiting,17
3,7,1099.9,533.5,212,1243,1455,2,targOff,17
3,7,1004.5,530.9,201,1480,1681,3,targOff,17
3,8,952.4,540.9,1323,11,1334,1,waiting,17
3,8,776.4,542,482,1382,1864,2,targOff,17
3,9,943.6,553.2,1337,-22,1315,1,waiting,17
3,9,930.9,551,97,1331,1428,2,dotOff,17
3,9,1130.5,552.9,443,1455,1898,3,targOff,17
3,10,954.5,535.9,783,-282,501,1,waiting,17
3,10,946.9,546.1,579,517,1096,2,waiting,17
3,10,1092.5,551.6,237,1120,1357,3,targOff,17
3,10,1132.8,552.3,128,1386,1514,4,targOff,17
3,11,954.1,547.1,1349,-25,1324,1,waiting,17
3,11,1128.5,547.7,483,1348,1831,2,targOff,17
3,12,940.5,542.5,336,-280,56,1,waiting,17
3,12,957.7,535.4,1328,72,1400,2,waiting,17
3,12,1109.1,542.5,441,1423,1864,3,targOff,17
3,13,948.1,544.1,1231,-107,1124,1,waiting,17
3,13,770.7,551.8,473,1174,1647,2,targOff,17
3,14,951.6,539.7,1373,-287,1086,1,waiting,17
3,14,1125.3,544,451,1113,1564,2,targOff,17
3,15,944,541.2,1673,-279,1394,1,waiting,17
3,15,787.8,535.1,464,1449,1913,2,targOff,17
3,16,947,537.8,1239,-56,1183,1,waiting,17
3,16,1119.1,551.4,453,1211,1664,2,targOff,17
3,17,947.6,547.2,857,-280,577,1,waiting,17
3,17,945.2,547.7,649,595,1244,2,waiting,17
3,17,772.3,550.2,441,1289,1730,3,targOff,17
3,18,950.5,542.5,1151,-84,1067,1,waiting,17
3,18,778.9,544.9,435,1096,1531,2,targOff,17
3,19,940.2,530.1,1547,-155,1392,1,waiting,17
3,19,773.5,539,461,1420,1881,2,targOff,17
3,20,948.3,543.4,1195,-67,1128,1,waiting,17
3,20,771.8,539.5,489,1171,1660,2,targOff,17
3,21,953.9,544,892,-42,850,1,waiting,17
3,21,797.3,539.8,551,876,1427,2,dotOff,17
3,21,868.9,537.7,37,1444,1481,3,targOff,17
3,22,968,547.3,310,-287,23,1,waiting,17
3,22,946.5,555.5,1319,50,1369,2,waiting,17
3,22,1097,555.4,420,1394,1814,3,targOff,17
3,23,954.3,541.5,1123,-288,835,1,waiting,17
3,23,839.8,546,309,856,1165,2,waiting,17
3,23,768.2,547.2,448,1199,1647,3,targOff,17
3,24,953.4,560,1295,12,1307,1,waiting,17
3,24,765.4,545.1,476,1338,1814,2,targOff,17
3,25,950.8,544.6,1041,-276,765,1,waiting,17
3,25,946.7,536.3,474,785,1259,2,waiting,17
3,25,1116.8,550.9,462,1285,1747,3,targOff,17
3,26,951.9,553.2,1671,-278,1393,1,waiting,17
3,26,785.7,566.6,358,1438,1796,2,targOff,17
3,26,898.1,552,61,1820,1881,3,targOff,17
3,27,964.1,555.2,295,-279,16,1,waiting,17
3,27,950.5,555.1,1888,40,1928,2,waiting,17
3,28,964.5,561.3,314,-280,34,1,waiting,17
3,28,955.4,554.5,1192,52,1244,2,waiting,17
3,28,759.8,546.7,623,1291,1914,3,dotOff,17
3,29,948,563.3,1324,18,1342,1,waiting,17
3,29,1120,562.2,429,1368,1797,2,targOff,17
3,30,941,558.2,1400,-44,1356,1,waiting,17
3,30,762.2,556.7,492,1386,1878,2,targOff,17
3,31,950,552.3,1448,-56,1392,1,waiting,17
3,31,775.6,560.7,463,1435,1898,2,targOff,17
3,32,947.6,555.7,1448,-42,1406,1,waiting,17
3,32,1121.9,548.2,481,1433,1914,2,targOff,17
3,33,954.7,548.2,1532,-72,1460,1,waiting,17
3,33,1119.2,557.3,447,1484,1931,2,targOff,17
3,34,945.2,549.6,1475,-284,1191,1,waiting,17
3,34,763.2,553.9,424,1240,1664,2,targOff,17
3,35,957.1,542.4,1166,-12,1154,1,waiting,17
3,35,1110.1,537.6,368,1179,1547,2,targOff,17
3,36,934.3,567,325,-287,38,1,waiting,17
3,36,949.4,554.8,1321,45,1366,2,waiting,17
3,36,1122.2,562.2,455,1393,1848,3,targOff,17
3,37,940.8,566,1190,-18,1172,1,waiting,17
3,37,767.2,559.6,474,1221,1695,2,targOff,17
3,38,944.8,555.1,1451,-61,1390,1,waiting,17
3,38,1105,553.1,466,1415,1881,2,targOff,17
3,39,963.9,545.4,223,-12,211,1,waiting,17
3,39,955.4,551.4,828,228,1056,2,waiting,17
3,39,789.2,551.3,347,1100,1447,3,targOff,17
3,40,950.1,541,1217,-17,1200,1,waiting,17
3,40,785.5,548.5,465,1228,1693,2,targOff,17
3,1,943.3,526.1,827,-254,573,1,waiting,18
3,1,954.4,547.7,1180,631,1811,2,waiting,18
3,2,942.6,512.1,1082,-271,811,1,waiting,18
3,2,950,516,53,817,870,2,dotOff,18
3,2,950,533.7,171,882,1053,3,dotOff,18
3,2,951.4,537.3,236,1065,1301,4,targOff,18
3,2,955.8,513.9,23,1317,1340,5,targOff,18
3,2,952.4,536.2,159,1355,1514,6,targOff,18
3,3,942.9,540.6,1962,-65,1897,1,waiting,18
3,4,948.4,537.8,2155,-275,1880,1,waiting,18
3,5,951.7,534.7,1797,-32,1765,1,waiting,18
3,5,948.7,531.2,129,1786,1915,2,targOff,18
3,6,947.1,549.5,1988,-274,1714,1,waiting,18
3,6,991.5,541.9,154,1727,1881,2,targOff,18
3,7,939.2,554.9,1132,-281,851,1,waiting,18
3,7,943.6,550.7,935,863,1798,2,waiting,18
3,8,950.8,544.7,1627,-102,1525,1,waiting,18
3,8,944.8,546.7,215,1545,1760,2,targOff,18
3,9,941.1,550.4,1957,-260,1697,1,waiting,18
3,10,946.8,547.5,1799,-285,1514,1,waiting,18
3,11,939.8,552.2,1730,-273,1457,1,waiting,18
3,11,770.5,549.8,360,1487,1847,2,targOff,18
3,12,912,536.7,187,-181,6,1,waiting,18
3,12,949.5,537,1347,25,1372,2,waiting,18
3,12,1137.3,525.8,252,1411,1663,3,targOff,18
3,13,956.3,543.8,1529,2,1531,1,waiting,18
3,14,952,530.9,52,9,61,1,waiting,18
3,14,922.9,531.6,142,89,231,2,waiting,18
3,14,951.9,539.9,1377,249,1626,3,waiting,18
3,15,972.3,533.8,384,-282,102,1,waiting,18
3,15,955.9,534.5,1613,118,1731,2,waiting,18
3,16,951.2,544.1,1971,-279,1692,1,waiting,18
3,17,953.8,552.7,286,-279,7,1,waiting,18
3,17,954.5,545.3,1538,26,1564,2,waiting,18
3,18,957.7,541.6,2058,-274,1784,1,waiting,18
3,18,955.5,531.7,126,1804,1930,2,targOff,18
3,19,931.5,542.2,543,-284,259,1,waiting,18
3,19,947.8,544,1440,279,1719,2,waiting,18
3,19,988.2,540.1,184,1729,1913,3,targOff,18
3,20,956.8,542.3,713,-283,430,1,waiting,18
3,20,949.2,540.4,1034,446,1480,2,waiting,18
3,21,946,542.1,1900,-272,1628,1,waiting,18
3,21,937.2,542.9,183,1648,1831,2,targOff,18
3,22,948.3,543.7,1943,-279,1664,1,waiting,18
3,23,950,547.3,1891,-43,1848,1,waiting,18
3,24,957.1,534.4,1574,-27,1547,1,waiting,18
3,25,942.3,545.8,1986,-122,1864,1,waiting,18
3,26,937.8,554.1,1580,-7,1573,1,waiting,18
3,26,996.4,547.4,124,1590,1714,2,targOff,18
3,27,947.2,555.3,1722,-58,1664,1,waiting,18
3,28,954,544.6,303,-273,30,1,waiting,18
3,28,945.9,536,1615,50,1665,2,waiting,18
3,29,955.9,541.3,1910,-148,1762,1,waiting,18
3,30,957.6,539.3,1742,-22,1720,1,waiting,18
3,30,944.2,530.9,186,1728,1914,2,targOff,18
3,31,951.7,539.4,1519,-3,1516,1,waiting,18
3,31,950,526.7,61,1537,1598,2,targOff,18
3,32,958.3,538.9,1749,-285,1464,1,waiting,18
3,33,949,533.7,1711,-214,1497,1,waiting,18
3,34,955.8,538.9,1765,-35,1730,1,waiting,18
3,35,943.8,537.4,2171,-273,1898,1,waiting,18
3,36,948.7,548.4,1695,-216,1479,1,waiting,18
3,37,942.2,555.5,1747,-67,1680,1,waiting,18
3,38,946.1,556,2097,-283,1814,1,waiting,18
3,39,935.5,540.5,488,-270,218,1,waiting,18
3,39,957.9,548.8,1511,236,1747,2,waiting,18
3,40,945.7,544.2,1650,-19,1631,1,waiting,18
3,1,949.7,542.6,1094,3,1097,1,waiting,19
3,1,1103.6,543.8,424,1123,1547,2,targOff,19
3,2,979.4,552.5,307,-280,27,1,waiting,19
3,2,957.5,546.2,1237,47,1284,2,waiting,19
3,2,1108,551.3,460,1320,1780,3,targOff,19
3,3,944,552,1477,-278,1199,1,waiting,19
3,3,770.9,555.9,310,1243,1553,2,targOff,19
3,3,754.4,554.2,121,1573,1694,3,targOff,19
3,4,958.2,547.1,283,-278,5,1,waiting,19
3,4,948.7,546.6,1272,23,1295,2,waiting,19
3,4,771.9,547.2,218,1346,1564,3,targOff,19
3,4,747.3,538.2,203,1595,1798,4,targOff,19
3,5,948.9,550.6,1338,18,1356,1,waiting,19
3,5,778.5,544.9,360,1385,1745,2,targOff,19
3,5,770.4,537,116,1765,1881,3,targOff,19
3,6,944.5,552.6,1503,-178,1325,1,waiting,19
3,6,766,554.6,443,1371,1814,2,targOff,19
3,7,947.7,544.2,1285,-24,1261,1,waiting,19
3,7,792.7,550.5,233,1293,1526,2,targOff,19
3,7,754.7,543.3,159,1555,1714,3,targOff,19
3,8,958.5,555.6,1256,-8,1248,1,waiting,19
3,8,1136.5,558.7,452,1278,1730,2,targOff,19
3,9,949.9,543.7,1227,-35,1192,1,waiting,19
3,9,1109.2,548,423,1220,1643,2,targOff,19
3,10,947.7,549.5,1239,-2,1237,1,waiting,19
3,10,786.3,552.6,480,1267,1747,2,targOff,19
3,11,946.9,541.3,1314,-278,1036,1,waiting,19
3,11,791.8,540.4,401,1062,1463,2,targOff,19
3,12,955.1,548.4,1597,-264,1333,1,waiting,19
3,12,1093,550.6,331,1357,1688,2,targOff,19
3,12,1125.4,546.8,84,1713,1797,3,targOff,19
3,13,953.6,543.5,1750,-285,1465,1,waiting,19
3,13,1107,546.5,358,1490,1848,2,targOff,19
3,13,1125.1,542.1,64,1867,1931,3,targOff,19
3,14,950.1,542.1,1272,-32,1240,1,waiting,19
3,14,1109.5,545.5,283,1264,1547,2,targOff,19
3,15,960.8,539.8,253,-141,112,1,waiting,19
3,15,952.9,542.5,1332,128,1460,2,waiting,19
3,15,1082,547.1,206,1486,1692,3,targOff,19
3,15,1123.2,531.2,192,1723,1915,4,targOff,19
3,16,952.9,540.5,1395,-280,1115,1,waiting,19
3,16,1082.5,539.2,202,1150,1352,2,targOff,19
3,16,1126.4,541,173,1372,1545,3,targOff,19
3,17,946.6,547.2,1497,-279,1218,1,waiting,19
3,17,1103,546.1,330,1243,1573,2,targOff,19
3,17,974,550.2,85,1596,1681,3,targOff,19
3,18,972.8,554.9,181,-160,21,1,waiting,19
3,18,942.6,550.2,1095,41,1136,2,waiting,19
3,18,1106,547,484,1163,1647,3,targOff,19
3,19,923.1,551.4,300,-280,20,1,waiting,19
3,19,942.1,554,1293,39,1332,2,waiting,19
3,19,1109.5,562,470,1357,1827,3,targOff,19
3,20,955.2,543.3,183,17,200,1,waiting,19
3,20,950.4,545,1104,215,1319,2,waiting,19
3,20,1109.6,549.6,285,1345,1630,3,targOff,19
3,20,1120.1,532.9,146,1648,1794,4,targOff,19
3,21,951.6,540.9,1678,-274,1404,1,waiting,19
3,21,1119.7,548.9,468,1429,1897,2,targOff,19
3,22,963.2,545.1,217,-166,51,1,waiting,19
3,22,955.3,546.9,1087,58,1145,2,waiting,19
3,22,1109.1,559.6,435,1179,1614,3,targOff,19
3,23,955.9,559.6,468,-271,197,1,waiting,19
3,23,939.3,556.6,1256,204,1460,2,waiting,19
3,23,1113.6,562.3,462,1486,1948,3,targOff,19
3,24,893.2,574.5,142,-122,20,1,waiting,19
3,24,948.7,567.4,1228,44,1272,2,waiting,19
3,24,1115.9,571.1,467,1297,1764,3,targOff,19
3,25,942.5,558.8,1565,-276,1289,1,waiting,19
3,25,780.4,566.4,273,1321,1594,2,targOff,19
3,25,761.3,569.4,212,1618,1830,3,targOff,19
3,26,956.2,557.8,790,-285,505,1,waiting,19
3,26,952.1,551.1,803,522,1325,2,waiting,19
3,26,1120.6,557.4,479,1351,1830,3,targOff,19
3,27,946.1,551.9,1371,-286,1085,1,waiting,19
3,27,1094.1,557,422,1109,1531,2,targOff,19
3,28,984.5,546.4,189,-177,12,1,waiting,19
3,28,945.3,547,1072,39,1111,2,waiting,19
3,28,1104.3,551.2,255,1134,1389,3,targOff,19
3,28,1128,545.9,152,1410,1562,4,targOff,19
3,29,941.2,556.7,1607,-272,1335,1,waiting,19
3,29,770.5,566.8,466,1381,1847,2,targOff,19
3,30,942.8,549.6,1320,-39,1281,1,waiting,19
3,30,1120.1,553.7,443,1304,1747,2,targOff,19
3,31,934.2,559.5,312,-284,28,1,waiting,19
3,31,940.4,557.2,1122,36,1158,2,waiting,19
3,31,789,559.5,267,1203,1470,3,targOff,19
3,31,762.6,550.4,189,1491,1680,4,targOff,19
3,32,827.1,562.3,280,-271,9,1,waiting,19
3,32,938.6,567.3,1264,31,1295,2,waiting,19
3,32,1106.1,575.1,487,1327,1814,3,targOff,19
3,33,949.1,552.5,315,-280,35,1,waiting,19
3,33,949.5,548.8,1204,54,1258,2,waiting,19
3,33,1110.4,550.1,277,1284,1561,3,targOff,19
3,33,1136.6,546.3,148,1582,1730,4,targOff,19
3,34,936.9,551.2,1494,-278,1216,1,waiting,19
3,34,775.8,550.8,484,1245,1729,2,targOff,19
3,35,926.5,545,497,-288,209,1,waiting,19
3,35,935.4,547.1,1080,225,1305,2,waiting,19
3,35,1104,546.9,266,1337,1603,3,targOff,19
3,35,1129.4,545.6,167,1630,1797,4,targOff,19
3,36,928.6,543.2,274,-274,0,1,waiting,19
3,36,940.7,552.5,1185,19,1204,2,waiting,19
3,36,1088.6,551.6,208,1229,1437,3,targOff,19
3,36,1125.5,552.5,213,1451,1664,4,targOff,19
3,37,946.8,546.9,1658,-271,1387,1,waiting,19
3,37,775.9,553.5,302,1414,1716,2,targOff,19
3,37,755.8,556,191,1723,1914,3,targOff,19
3,38,942.1,557.6,1382,-283,1099,1,waiting,19
3,38,765.2,556.8,469,1145,1614,2,targOff,19
3,39,941.7,563.8,1321,-14,1307,1,waiting,19
3,39,774.3,546.4,498,1332,1830,2,targOff,19
3,40,940.1,552.2,1694,-284,1410,1,waiting,19
3,40,768.1,556.1,508,1439,1947,2,targOff,19
3,1,1123.5,545.1,176,-148,28,1,waiting,20
3,1,970.8,544.9,1740,54,1794,2,waiting,20
3,2,967.1,548.7,1874,-43,1831,1,waiting,20
3,3,974.2,534.7,567,-285,282,1,waiting,20
3,3,928.8,534.5,99,293,392,2,waiting,20
3,3,974.9,537,1258,405,1663,3,waiting,20
3,4,964.9,533.4,2014,-167,1847,1,waiting,20
3,5,958.4,524.7,1853,-272,1581,1,waiting,20
3,6,955,543.2,1755,-285,1470,1,waiting,20
3,6,1006.8,531.1,164,1483,1647,2,targOff,20
3,7,956.6,550.7,2201,-286,1915,1,waiting,20
3,8,960,537,1930,-282,1648,1,waiting,20
3,9,955,537.4,1801,-272,1529,1,waiting,20
3,10,946.5,541.7,1964,0,1964,1,waiting,20
3,11,953.7,541,1753,-273,1480,1,waiting,20
3,12,947.5,537.2,1786,-272,1514,1,waiting,20
3,13,943.6,539.8,2191,-277,1914,1,waiting,20
3,14,938.1,537.2,1805,-278,1527,1,waiting,20
3,15,949.1,531.7,1877,-283,1594,1,waiting,20
3,16,940.3,544.6,1900,-286,1614,1,waiting,20
3,17,947.2,538.8,2197,-283,1914,1,waiting,20
3,18,949.4,538,2053,-277,1776,1,waiting,20
3,19,946,544.3,1852,-288,1564,1,waiting,20
3,20,944.1,543.7,1759,-278,1481,1,waiting,20
3,21,953.1,544.4,1830,-283,1547,1,waiting,20
3,22,947.4,539.3,1823,-279,1544,1,waiting,20
3,23,944.1,538.7,1921,-273,1648,1,waiting,20
3,24,949.8,542.6,2067,-286,1781,1,waiting,20
3,25,948.8,536.2,714,-32,682,1,waiting,20
3,25,941.9,533.9,1175,689,1864,2,waiting,20
3,26,939.4,536.2,1801,-287,1514,1,waiting,20
3,27,940.1,565.5,1911,-280,1631,1,waiting,20
3,28,949,554.5,1883,-286,1597,1,waiting,20
3,29,946.8,551.4,2089,-275,1814,1,waiting,20
3,30,943.3,544.8,1814,-199,1615,1,waiting,20
3,31,945.4,559.7,1907,-43,1864,1,waiting,20
3,32,941.8,574.3,2209,-279,1930,1,waiting,20
3,33,954.4,554.1,1386,-4,1382,1,waiting,20
3,33,948.1,551.3,180,1400,1580,2,targOff,20
3,34,955.7,548.4,2081,-284,1797,1,waiting,20
3,35,963.7,545.1,311,-285,26,1,waiting,20
3,35,951.1,546.9,1505,42,1547,2,waiting,20
3,36,951,546.9,1917,-273,1644,1,waiting,20
3,36,878.4,550.4,102,1662,1764,2,targOff,20
3,37,958.5,542,303,-288,15,1,waiting,20
3,37,951.2,548.6,1650,31,1681,2,waiting,20
3,37,938.3,543.1,209,1705,1914,3,targOff,20
3,38,951.4,559.5,2235,-271,1964,1,waiting,20
3,39,955.7,547,1917,-270,1647,1,waiting,20
3,40,950.6,559.4,1208,-139,1069,1,waiting,20
3,40,939.7,563.2,462,1085,1547,2,targOff,20
